A.C. Green ,1,23,16,1985,1986,1,3.3
A.C. Green ,1,23,16,1985,1987,2,7.6
A.C. Green ,1,23,16,1985,1988,3,7.9
A.C. Green ,1,23,16,1985,1989,4,9.4
A.C. Green ,1,23,16,1985,1990,5,7.7
A.C. Green ,1,23,16,1985,1991,6,6.1
A.C. Green ,1,23,16,1985,1992,7,8.8
A.C. Green ,1,23,16,1985,1993,8,8.6
A.C. Green ,1,23,16,1985,1994,9,9.3
A.C. Green ,1,23,16,1985,1995,10,6.7
A.C. Green ,1,23,16,1985,1996,11,4.4
A.C. Green ,1,23,16,1985,1997,12,4.8
A.C. Green ,1,23,16,1985,1998,13,5.2
A.C. Green ,1,23,16,1985,1999,14,1.4
A.C. Green ,1,23,16,1985,2000,15,5
A.C. Green ,1,23,16,1985,2001,16,3.2
A.J. Bramlett ,2,39,1,1999,2000,1,-0.2
A.J. English ,3,37,2,1990,1991,1,0.2
A.J. English ,3,37,2,1990,1992,2,0.9
A.J. Guyton ,4,32,3,2000,2001,1,0.3
A.J. Guyton ,4,32,3,2000,2002,2,0.1
A.J. Guyton ,4,32,3,2000,2003,3,-0.1
Aaron Brooks ,5,26,8,2007,2008,1,1.4
Aaron Brooks ,5,26,8,2007,2009,2,3.6
Aaron Brooks ,5,26,8,2007,2010,3,5.5
Aaron Brooks ,5,26,8,2007,2011,4,1.1
Aaron Brooks ,5,26,8,2007,2013,6,0.8
Aaron Brooks ,5,26,8,2007,2014,7,2.2
Aaron Brooks ,5,26,8,2007,2015,8,3.3
Aaron Brooks ,5,26,8,2007,2016,9,0.9
Aaron Gordon ,6,4,2,2014,2015,1,1
Aaron Gordon ,6,4,2,2014,2016,2,5.4
Aaron Gray ,7,49,7,2007,2008,1,0.8
Aaron Gray ,7,49,7,2007,2009,2,1.3
Aaron Gray ,7,49,7,2007,2010,3,0.9
Aaron Gray ,7,49,7,2007,2011,4,1.1
Aaron Gray ,7,49,7,2007,2012,5,1.4
Aaron Gray ,7,49,7,2007,2013,6,0.5
Aaron Gray ,7,49,7,2007,2014,7,0.1
Aaron McKie ,8,17,13,1994,1995,1,2
Aaron McKie ,8,17,13,1994,1996,2,5.3
Aaron McKie ,8,17,13,1994,1997,3,3.5
Aaron McKie ,8,17,13,1994,1998,4,1.4
Aaron McKie ,8,17,13,1994,1999,5,1.6
Aaron McKie ,8,17,13,1994,2000,6,4.3
Aaron McKie ,8,17,13,1994,2001,7,5.9
Aaron McKie ,8,17,13,1994,2002,8,3.9
Aaron McKie ,8,17,13,1994,2003,9,5.1
Aaron McKie ,8,17,13,1994,2004,10,4.8
Aaron McKie ,8,17,13,1994,2005,11,2
Aaron McKie ,8,17,13,1994,2006,12,0.1
Aaron McKie ,8,17,13,1994,2007,13,0.1
Acie Earl ,9,19,4,1993,1994,1,0.2
Acie Earl ,9,19,4,1993,1995,2,-0.2
Acie Earl ,9,19,4,1993,1996,3,0.3
Acie Earl ,9,19,4,1993,1997,4,0
Acie Law ,10,11,4,2007,2008,1,-0.1
Acie Law ,10,11,4,2007,2009,2,0.7
Acie Law ,10,11,4,2007,2010,3,0.6
Acie Law ,10,11,4,2007,2011,4,0.4
Adam Keefe ,11,10,9,1992,1993,1,3.3
Adam Keefe ,11,10,9,1992,1994,2,1.4
Adam Keefe ,11,10,9,1992,1995,3,4.1
Adam Keefe ,11,10,9,1992,1996,4,4.6
Adam Keefe ,11,10,9,1992,1997,5,2.3
Adam Keefe ,11,10,9,1992,1998,6,6.5
Adam Keefe ,11,10,9,1992,1999,7,1.7
Adam Keefe ,11,10,9,1992,2000,8,0.4
Adam Keefe ,11,10,9,1992,2001,9,0.6
Adam Morrison ,12,3,3,2006,2007,1,-1.5
Adam Morrison ,12,3,3,2006,2009,3,0
Adam Morrison ,12,3,3,2006,2010,4,0
Adonal Foyle ,13,8,12,1997,1998,1,-0.1
Adonal Foyle ,13,8,12,1997,1999,2,1.1
Adonal Foyle ,13,8,12,1997,2000,3,1.9
Adonal Foyle ,13,8,12,1997,2001,4,0.7
Adonal Foyle ,13,8,12,1997,2002,5,1.2
Adonal Foyle ,13,8,12,1997,2003,6,4
Adonal Foyle ,13,8,12,1997,2004,7,1.1
Adonal Foyle ,13,8,12,1997,2005,8,3.4
Adonal Foyle ,13,8,12,1997,2006,9,2.8
Adonal Foyle ,13,8,12,1997,2007,10,1
Adonal Foyle ,13,8,12,1997,2008,11,1.3
Adonal Foyle ,13,8,12,1997,2009,12,0.3
Adonis Jordan ,14,42,2,1993,1994,1,-0.1
Adonis Jordan ,14,42,2,1993,1999,6,0
Adreian Payne ,15,15,2,2014,2015,1,-0.5
Adreian Payne ,15,15,2,2014,2016,2,-0.5
Adrian Branch ,16,46,4,1985,1987,2,0.7
Adrian Branch ,16,46,4,1985,1988,3,-0.1
Adrian Branch ,16,46,4,1985,1989,4,1.5
Adrian Branch ,16,46,4,1985,1990,5,0
Al Harrington ,17,25,16,1998,1999,1,-0.2
Al Harrington ,17,25,16,1998,2000,2,1
Al Harrington ,17,25,16,1998,2001,3,1.2
Al Harrington ,17,25,16,1998,2002,4,2.6
Al Harrington ,17,25,16,1998,2003,5,3.9
Al Harrington ,17,25,16,1998,2004,6,5.9
Al Harrington ,17,25,16,1998,2005,7,1.6
Al Harrington ,17,25,16,1998,2006,8,3.8
Al Harrington ,17,25,16,1998,2007,9,4.3
Al Harrington ,17,25,16,1998,2008,10,5.4
Al Harrington ,17,25,16,1998,2009,11,3.9
Al Harrington ,17,25,16,1998,2010,12,3.5
Al Harrington ,17,25,16,1998,2011,13,2.1
Al Harrington ,17,25,16,1998,2012,14,3.2
Al Harrington ,17,25,16,1998,2013,15,0
Al Harrington ,17,25,16,1998,2014,16,0.4
Al Horford ,18,3,9,2007,2008,1,5.5
Al Horford ,18,3,9,2007,2009,2,6.8
Al Horford ,18,3,9,2007,2010,3,10.9
Al Horford ,18,3,9,2007,2011,4,10.1
Al Horford ,18,3,9,2007,2012,5,1.3
Al Horford ,18,3,9,2007,2013,6,8.8
Al Horford ,18,3,9,2007,2014,7,2.8
Al Horford ,18,3,9,2007,2015,8,8.7
Al Horford ,18,3,9,2007,2016,9,9.4
Al Jefferson ,19,15,12,2004,2005,1,2.7
Al Jefferson ,19,15,12,2004,2006,2,2.3
Al Jefferson ,19,15,12,2004,2007,3,6.6
Al Jefferson ,19,15,12,2004,2008,4,7.7
Al Jefferson ,19,15,12,2004,2009,5,4.9
Al Jefferson ,19,15,12,2004,2010,6,4.6
Al Jefferson ,19,15,12,2004,2011,7,7.8
Al Jefferson ,19,15,12,2004,2012,8,7.5
Al Jefferson ,19,15,12,2004,2013,9,7.7
Al Jefferson ,19,15,12,2004,2014,10,7.8
Al Jefferson ,19,15,12,2004,2015,11,4.7
Al Jefferson ,19,15,12,2004,2016,12,2.8
Al Thornton ,20,14,4,2007,2008,1,1.1
Al Thornton ,20,14,4,2007,2009,2,1.3
Al Thornton ,20,14,4,2007,2010,3,2.2
Al Thornton ,20,14,4,2007,2011,4,1.6
Al Wood ,21,4,6,1981,1982,1,0.9
Al Wood ,21,4,6,1981,1983,2,2.3
Al Wood ,21,4,6,1981,1984,3,4.4
Al Wood ,21,4,6,1981,1985,4,4.2
Al Wood ,21,4,6,1981,1986,5,2.5
Al Wood ,21,4,6,1981,1987,6,1
Al-Farouq Aminu ,22,8,6,2010,2011,1,0.7
Al-Farouq Aminu ,22,8,6,2010,2012,2,1.4
Al-Farouq Aminu ,22,8,6,2010,2013,3,3.1
Al-Farouq Aminu ,22,8,6,2010,2014,4,3.1
Al-Farouq Aminu ,22,8,6,2010,2015,5,3.3
Al-Farouq Aminu ,22,8,6,2010,2016,6,4
Alaa Abdelnaby ,23,25,5,1990,1991,1,0.5
Alaa Abdelnaby ,23,25,5,1990,1992,2,2.1
Alaa Abdelnaby ,23,25,5,1990,1993,3,2
Alaa Abdelnaby ,23,25,5,1990,1994,4,-0.1
Alaa Abdelnaby ,23,25,5,1990,1995,5,0.3
Alan Henderson ,24,16,12,1995,1996,1,2
Alan Henderson ,24,16,12,1995,1997,2,1.3
Alan Henderson ,24,16,12,1995,1998,3,6
Alan Henderson ,24,16,12,1995,1999,4,3.1
Alan Henderson ,24,16,12,1995,2000,5,4.3
Alan Henderson ,24,16,12,1995,2001,6,1.9
Alan Henderson ,24,16,12,1995,2002,7,0.7
Alan Henderson ,24,16,12,1995,2003,8,2.6
Alan Henderson ,24,16,12,1995,2004,9,0.2
Alan Henderson ,24,16,12,1995,2005,10,3.1
Alan Henderson ,24,16,12,1995,2006,11,1.3
Alan Henderson ,24,16,12,1995,2007,12,1.6
Alando Tucker ,25,29,3,2007,2008,1,0
Alando Tucker ,25,29,3,2007,2009,2,0.2
Alando Tucker ,25,29,3,2007,2010,3,0.1
Albert King ,26,10,9,1981,1982,1,2.4
Albert King ,26,10,9,1981,1983,2,5.7
Albert King ,26,10,9,1981,1984,3,4.3
Albert King ,26,10,9,1981,1985,4,1.9
Albert King ,26,10,9,1981,1986,5,1.9
Albert King ,26,10,9,1981,1987,6,0.2
Albert King ,26,10,9,1981,1988,7,-0.1
Albert King ,26,10,9,1981,1989,8,0
Albert King ,26,10,9,1981,1992,11,0.1
Alec Burks ,27,12,5,2011,2012,1,1.5
Alec Burks ,27,12,5,2011,2013,2,1
Alec Burks ,27,12,5,2011,2014,3,3.2
Alec Burks ,27,12,5,2011,2015,4,1.7
Alec Burks ,27,12,5,2011,2016,5,1.5
Alec Kessler ,28,12,4,1990,1991,1,-0.1
Alec Kessler ,28,12,4,1990,1992,2,1.2
Alec Kessler ,28,12,4,1990,1993,3,0.8
Alec Kessler ,28,12,4,1990,1994,4,0.1
Aleksandar Radojevic ,29,12,2,1999,2000,1,-0.1
Aleksandar Radojevic ,29,12,2,1999,2005,6,-0.3
Alex Len ,30,5,3,2013,2014,1,0.2
Alex Len ,30,5,3,2013,2015,2,3.4
Alex Len ,30,5,3,2013,2016,3,1.3
Alexander Johnson ,31,45,2,2006,2007,1,1.3
Alexander Johnson ,31,45,2,2006,2008,2,0.2
Alexis Ajinca ,32,20,6,2008,2009,1,-0.1
Alexis Ajinca ,32,20,6,2008,2010,2,0
Alexis Ajinca ,32,20,6,2008,2011,3,0.4
Alexis Ajinca ,32,20,6,2008,2014,6,2.1
Alexis Ajinca ,32,20,6,2008,2015,7,3.2
Alexis Ajinca ,32,20,6,2008,2016,8,1
Alfredrick Hughes ,33,14,1,1985,1986,1,-0.5
Allan Houston ,34,11,12,1993,1994,1,-1.2
Allan Houston ,34,11,12,1993,1995,2,3.8
Allan Houston ,34,11,12,1993,1996,3,7.1
Allan Houston ,34,11,12,1993,1997,4,4.7
Allan Houston ,34,11,12,1993,1998,5,6.1
Allan Houston ,34,11,12,1993,1999,6,2.9
Allan Houston ,34,11,12,1993,2000,7,8.6
Allan Houston ,34,11,12,1993,2001,8,7.5
Allan Houston ,34,11,12,1993,2002,9,4.7
Allan Houston ,34,11,12,1993,2003,10,7.2
Allan Houston ,34,11,12,1993,2004,11,3.1
Allan Houston ,34,11,12,1993,2005,12,0.7
Allen Crabbe ,35,31,3,2013,2014,1,0.1
Allen Crabbe ,35,31,3,2013,2015,2,1.3
Allen Crabbe ,35,31,3,2013,2016,3,4.3
Allen Iverson ,36,1,14,1996,1998,2,9
Allen Iverson ,36,1,14,1996,1999,3,7.2
Allen Iverson ,36,1,14,1996,2000,4,6.9
Allen Iverson ,36,1,14,1996,2001,5,11.8
Allen Iverson ,36,1,14,1996,2002,6,6.9
Allen Iverson ,36,1,14,1996,2003,7,9.2
Allen Iverson ,36,1,14,1996,2004,8,2.8
Allen Iverson ,36,1,14,1996,2005,9,9
Allen Iverson ,36,1,14,1996,2006,10,10.6
Allen Iverson ,36,1,14,1996,2009,13,2.9
Allen Iverson ,36,1,14,1996,2010,14,0.7
Alphonso Ford ,37,32,2,1993,1994,1,0.1
Alphonso Ford ,37,32,2,1993,1995,2,-0.4
Alton Ford ,38,50,3,2001,2002,1,0.8
Alton Ford ,38,50,3,2001,2003,2,-0.1
Alton Ford ,38,50,3,2001,2004,3,0.1
Alton Lister ,39,21,16,1981,1982,1,1.7
Alton Lister ,39,21,16,1981,1983,2,3.8
Alton Lister ,39,21,16,1981,1984,3,4
Alton Lister ,39,21,16,1981,1985,4,5.3
Alton Lister ,39,21,16,1981,1986,5,5.5
Alton Lister ,39,21,16,1981,1987,6,4.1
Alton Lister ,39,21,16,1981,1988,7,4.1
Alton Lister ,39,21,16,1981,1989,8,3.7
Alton Lister ,39,21,16,1981,1990,9,0.1
Alton Lister ,39,21,16,1981,1991,10,1.9
Alton Lister ,39,21,16,1981,1992,11,0.4
Alton Lister ,39,21,16,1981,1993,12,-0.2
Alton Lister ,39,21,16,1981,1995,14,1
Alton Lister ,39,21,16,1981,1996,15,0.9
Alton Lister ,39,21,16,1981,1997,16,0.3
Alton Lister ,39,21,16,1981,1998,17,0
Alvin Robertson ,40,7,10,1984,1985,1,3.1
Alvin Robertson ,40,7,10,1984,1986,2,8.6
Alvin Robertson ,40,7,10,1984,1987,3,5.3
Alvin Robertson ,40,7,10,1984,1988,4,5.8
Alvin Robertson ,40,7,10,1984,1989,5,4.4
Alvin Robertson ,40,7,10,1984,1990,6,7.5
Alvin Robertson ,40,7,10,1984,1991,7,7.7
Alvin Robertson ,40,7,10,1984,1992,8,3.6
Alvin Robertson ,40,7,10,1984,1993,9,3.4
Alvin Robertson ,40,7,10,1984,1996,12,2.8
Alvin Williams ,41,47,9,1997,1998,1,1.3
Alvin Williams ,41,47,9,1997,1999,2,1.2
Alvin Williams ,41,47,9,1997,2000,3,1
Alvin Williams ,41,47,9,1997,2001,4,5.4
Alvin Williams ,41,47,9,1997,2002,5,5.2
Alvin Williams ,41,47,9,1997,2003,6,5.5
Alvin Williams ,41,47,9,1997,2004,7,2.1
Alvin Williams ,41,47,9,1997,2006,9,-0.1
Alvin Williams ,41,47,9,1997,2007,10,-0.1
Amal McCaskill ,42,49,4,1996,1997,1,-0.2
Amal McCaskill ,42,49,4,1996,2002,6,0
Amal McCaskill ,42,49,4,1996,2003,7,0
Amal McCaskill ,42,49,4,1996,2004,8,0.6
Amar'e Stoudemire ,43,9,14,2002,2003,1,6.2
Amar'e Stoudemire ,43,9,14,2002,2004,2,4.4
Amar'e Stoudemire ,43,9,14,2002,2005,3,14.6
Amar'e Stoudemire ,43,9,14,2002,2006,4,0.1
Amar'e Stoudemire ,43,9,14,2002,2007,5,11.2
Amar'e Stoudemire ,43,9,14,2002,2008,6,14.6
Amar'e Stoudemire ,43,9,14,2002,2009,7,6.1
Amar'e Stoudemire ,43,9,14,2002,2010,8,10.7
Amar'e Stoudemire ,43,9,14,2002,2011,9,8
Amar'e Stoudemire ,43,9,14,2002,2012,10,4.1
Amar'e Stoudemire ,43,9,14,2002,2013,11,2.7
Amar'e Stoudemire ,43,9,14,2002,2014,12,3.8
Amar'e Stoudemire ,43,9,14,2002,2015,13,3.6
Amar'e Stoudemire ,43,9,14,2002,2016,14,2.4
Anderson Varejao ,44,30,12,2004,2005,1,3
Anderson Varejao ,44,30,12,2004,2006,2,2.3
Anderson Varejao ,44,30,12,2004,2007,3,6.6
Anderson Varejao ,44,30,12,2004,2008,4,2.4
Anderson Varejao ,44,30,12,2004,2009,5,8
Anderson Varejao ,44,30,12,2004,2010,6,8.1
Anderson Varejao ,44,30,12,2004,2011,7,2.2
Anderson Varejao ,44,30,12,2004,2012,8,2.1
Anderson Varejao ,44,30,12,2004,2013,9,3.3
Anderson Varejao ,44,30,12,2004,2014,10,5.4
Anderson Varejao ,44,30,12,2004,2015,11,1.9
Anderson Varejao ,44,30,12,2004,2016,12,1
Andrae Patterson ,45,46,2,1998,1999,1,0.7
Andrae Patterson ,45,46,2,1998,2000,2,0.1
Andray Blatche ,46,49,9,2005,2006,1,0.1
Andray Blatche ,46,49,9,2005,2007,2,0.5
Andray Blatche ,46,49,9,2005,2008,3,3
Andray Blatche ,46,49,9,2005,2009,4,1.4
Andray Blatche ,46,49,9,2005,2010,5,3.4
Andray Blatche ,46,49,9,2005,2011,6,2.4
Andray Blatche ,46,49,9,2005,2012,7,-0.1
Andray Blatche ,46,49,9,2005,2013,8,4.9
Andray Blatche ,46,49,9,2005,2014,9,3.7
Andre Drummond ,47,9,4,2012,2013,1,4.5
Andre Drummond ,47,9,4,2012,2014,2,9.9
Andre Drummond ,47,9,4,2012,2015,3,7.7
Andre Drummond ,47,9,4,2012,2016,4,7.4
Andre Emmett ,48,35,2,2004,2005,1,0
Andre Emmett ,48,35,2,2004,2012,8,0.1
Andre Iguodala ,49,9,12,2004,2005,1,6.6
Andre Iguodala ,49,9,12,2004,2006,2,7.5
Andre Iguodala ,49,9,12,2004,2007,3,7.7
Andre Iguodala ,49,9,12,2004,2008,4,9.6
Andre Iguodala ,49,9,12,2004,2009,5,9.2
Andre Iguodala ,49,9,12,2004,2010,6,6.7
Andre Iguodala ,49,9,12,2004,2011,7,6.7
Andre Iguodala ,49,9,12,2004,2012,8,7.3
Andre Iguodala ,49,9,12,2004,2013,9,5.6
Andre Iguodala ,49,9,12,2004,2014,10,5.8
Andre Iguodala ,49,9,12,2004,2015,11,5.1
Andre Iguodala ,49,9,12,2004,2016,12,4.4
Andre Miller ,50,8,17,1999,2000,1,5.3
Andre Miller ,50,8,17,1999,2001,2,8
Andre Miller ,50,8,17,1999,2002,3,10.3
Andre Miller ,50,8,17,1999,2003,4,4.6
Andre Miller ,50,8,17,1999,2004,5,8.8
Andre Miller ,50,8,17,1999,2005,6,7
Andre Miller ,50,8,17,1999,2006,7,6.2
Andre Miller ,50,8,17,1999,2007,8,5.9
Andre Miller ,50,8,17,1999,2008,9,8.3
Andre Miller ,50,8,17,1999,2009,10,8.8
Andre Miller ,50,8,17,1999,2010,11,7
Andre Miller ,50,8,17,1999,2011,12,7
Andre Miller ,50,8,17,1999,2012,13,2.9
Andre Miller ,50,8,17,1999,2013,14,5.4
Andre Miller ,50,8,17,1999,2014,15,2.2
Andre Miller ,50,8,17,1999,2015,16,2.2
Andre Miller ,50,8,17,1999,2016,17,1
Andre Moore ,51,31,1,1987,1988,1,0
Andre Roberson ,52,26,3,2013,2014,1,0.8
Andre Roberson ,52,26,3,2013,2015,2,2.1
Andre Roberson ,52,26,3,2013,2016,3,3.4
Andrea Bargnani ,53,1,10,2006,2007,1,1.9
Andrea Bargnani ,53,1,10,2006,2008,2,1.4
Andrea Bargnani ,53,1,10,2006,2009,3,3.9
Andrea Bargnani ,53,1,10,2006,2010,4,4.2
Andrea Bargnani ,53,1,10,2006,2011,5,2.5
Andrea Bargnani ,53,1,10,2006,2012,6,2.2
Andrea Bargnani ,53,1,10,2006,2013,7,0.1
Andrea Bargnani ,53,1,10,2006,2014,8,1.5
Andrea Bargnani ,53,1,10,2006,2015,9,0.9
Andrea Bargnani ,53,1,10,2006,2016,10,0.2
Andrei Kirilenko ,54,24,13,1999,2002,3,7.3
Andrei Kirilenko ,54,24,13,1999,2003,4,9.2
Andrei Kirilenko ,54,24,13,1999,2004,5,11.6
Andrei Kirilenko ,54,24,13,1999,2005,6,5.5
Andrei Kirilenko ,54,24,13,1999,2006,7,7.9
Andrei Kirilenko ,54,24,13,1999,2007,8,4.4
Andrei Kirilenko ,54,24,13,1999,2008,9,7.1
Andrei Kirilenko ,54,24,13,1999,2009,10,4.6
Andrei Kirilenko ,54,24,13,1999,2010,11,6
Andrei Kirilenko ,54,24,13,1999,2011,12,4.5
Andrei Kirilenko ,54,24,13,1999,2013,14,6
Andrei Kirilenko ,54,24,13,1999,2014,15,1.3
Andrei Kirilenko ,54,24,13,1999,2015,16,0
Andrew Bogut ,55,1,11,2005,2006,1,5.5
Andrew Bogut ,55,1,11,2005,2007,2,4
Andrew Bogut ,55,1,11,2005,2008,3,4.8
Andrew Bogut ,55,1,11,2005,2009,4,2.6
Andrew Bogut ,55,1,11,2005,2010,5,7.5
Andrew Bogut ,55,1,11,2005,2011,6,5.4
Andrew Bogut ,55,1,11,2005,2012,7,0.5
Andrew Bogut ,55,1,11,2005,2013,8,1.7
Andrew Bogut ,55,1,11,2005,2014,9,6.5
Andrew Bogut ,55,1,11,2005,2015,10,5.2
Andrew Bogut ,55,1,11,2005,2016,11,5.4
Andrew Bynum ,56,10,8,2005,2006,1,0.1
Andrew Bynum ,56,10,8,2005,2007,2,4.2
Andrew Bynum ,56,10,8,2005,2008,3,4.8
Andrew Bynum ,56,10,8,2005,2009,4,5.5
Andrew Bynum ,56,10,8,2005,2010,5,7.8
Andrew Bynum ,56,10,8,2005,2011,6,6.6
Andrew Bynum ,56,10,8,2005,2012,7,8
Andrew Bynum ,56,10,8,2005,2014,9,0.4
Andrew DeClercq ,57,34,10,1995,1996,1,0.4
Andrew DeClercq ,57,34,10,1995,1997,2,1.6
Andrew DeClercq ,57,34,10,1995,1998,3,3.4
Andrew DeClercq ,57,34,10,1995,1999,4,3.1
Andrew DeClercq ,57,34,10,1995,2000,5,2.9
Andrew DeClercq ,57,34,10,1995,2001,6,2.5
Andrew DeClercq ,57,34,10,1995,2002,7,1
Andrew DeClercq ,57,34,10,1995,2003,8,2.6
Andrew DeClercq ,57,34,10,1995,2004,9,1.7
Andrew DeClercq ,57,34,10,1995,2005,10,0.1
Andrew Goudelock ,58,46,3,2011,2012,1,0.1
Andrew Goudelock ,58,46,3,2011,2013,2,0
Andrew Goudelock ,58,46,3,2011,2016,5,0
Andrew Lang ,59,28,12,1988,1989,1,1.4
Andrew Lang ,59,28,12,1988,1990,2,3
Andrew Lang ,59,28,12,1988,1991,3,3.7
Andrew Lang ,59,28,12,1988,1992,4,5.7
Andrew Lang ,59,28,12,1988,1993,5,1.7
Andrew Lang ,59,28,12,1988,1994,6,2.9
Andrew Lang ,59,28,12,1988,1995,7,4.9
Andrew Lang ,59,28,12,1988,1996,8,2.3
Andrew Lang ,59,28,12,1988,1997,9,1.9
Andrew Lang ,59,28,12,1988,1998,10,0.7
Andrew Lang ,59,28,12,1988,1999,11,-0.1
Andrew Lang ,59,28,12,1988,2000,12,0.4
Andrew Nicholson ,60,19,4,2012,2013,1,1.7
Andrew Nicholson ,60,19,4,2012,2014,2,0.6
Andrew Nicholson ,60,19,4,2012,2015,3,0.1
Andrew Nicholson ,60,19,4,2012,2016,4,1.6
Andrew Toney ,61,8,8,1980,1981,1,2.2
Andrew Toney ,61,8,8,1980,1982,2,4
Andrew Toney ,61,8,8,1980,1983,3,7.3
Andrew Toney ,61,8,8,1980,1984,4,6.4
Andrew Toney ,61,8,8,1980,1985,5,5.5
Andrew Toney ,61,8,8,1980,1986,6,-0.2
Andrew Toney ,61,8,8,1980,1987,7,1.2
Andrew Toney ,61,8,8,1980,1988,8,0.5
Andrew Wiggins ,62,1,2,2014,2015,1,2.1
Andrew Wiggins ,62,1,2,2014,2016,2,4.1
Andris Biedrins ,63,11,10,2004,2005,1,1.2
Andris Biedrins ,63,11,10,2004,2006,2,2.9
Andris Biedrins ,63,11,10,2004,2007,3,6.7
Andris Biedrins ,63,11,10,2004,2008,4,8
Andris Biedrins ,63,11,10,2004,2009,5,5.4
Andris Biedrins ,63,11,10,2004,2010,6,1.6
Andris Biedrins ,63,11,10,2004,2011,7,2.6
Andris Biedrins ,63,11,10,2004,2012,8,1.3
Andris Biedrins ,63,11,10,2004,2013,9,1.1
Andris Biedrins ,63,11,10,2004,2014,10,0
Andy Rautins ,64,38,1,2010,2011,1,-0.2
Anfernee Hardaway ,65,3,14,1993,1994,1,7.1
Anfernee Hardaway ,65,3,14,1993,1995,2,10.7
Anfernee Hardaway ,65,3,14,1993,1996,3,14.4
Anfernee Hardaway ,65,3,14,1993,1997,4,8.1
Anfernee Hardaway ,65,3,14,1993,1998,5,1.1
Anfernee Hardaway ,65,3,14,1993,1999,6,5
Anfernee Hardaway ,65,3,14,1993,2000,7,7.8
Anfernee Hardaway ,65,3,14,1993,2001,8,0.4
Anfernee Hardaway ,65,3,14,1993,2002,9,2.9
Anfernee Hardaway ,65,3,14,1993,2003,10,2.3
Anfernee Hardaway ,65,3,14,1993,2004,11,2
Anfernee Hardaway ,65,3,14,1993,2005,12,0.2
Anfernee Hardaway ,65,3,14,1993,2006,13,-0.2
Anfernee Hardaway ,65,3,14,1993,2008,15,0.2
Ansu Sesay ,66,30,4,1998,2002,4,0.5
Ansu Sesay ,66,30,4,1998,2003,5,-0.1
Ansu Sesay ,66,30,4,1998,2004,6,0.8
Ansu Sesay ,66,30,4,1998,2005,7,0.2
Antawn Jamison ,67,4,16,1998,1999,1,2.3
Antawn Jamison ,67,4,16,1998,2000,2,1.4
Antawn Jamison ,67,4,16,1998,2001,3,6.7
Antawn Jamison ,67,4,16,1998,2002,4,6.4
Antawn Jamison ,67,4,16,1998,2003,5,8.5
Antawn Jamison ,67,4,16,1998,2004,6,9
Antawn Jamison ,67,4,16,1998,2005,7,5.4
Antawn Jamison ,67,4,16,1998,2006,8,8.2
Antawn Jamison ,67,4,16,1998,2007,9,6.8
Antawn Jamison ,67,4,16,1998,2008,10,9.2
Antawn Jamison ,67,4,16,1998,2009,11,8.1
Antawn Jamison ,67,4,16,1998,2010,12,5.8
Antawn Jamison ,67,4,16,1998,2011,13,2.6
Antawn Jamison ,67,4,16,1998,2012,14,3.1
Antawn Jamison ,67,4,16,1998,2013,15,4.3
Antawn Jamison ,67,4,16,1998,2014,16,0.1
Anthony Avent ,68,15,6,1991,1993,2,0.3
Anthony Avent ,68,15,6,1991,1994,3,0.4
Anthony Avent ,68,15,6,1991,1995,4,1.5
Anthony Avent ,68,15,6,1991,1996,5,-1.2
Anthony Avent ,68,15,6,1991,1999,8,-0.1
Anthony Avent ,68,15,6,1991,2000,9,-0.5
Anthony Bennett ,69,1,3,2013,2014,1,-0.4
Anthony Bennett ,69,1,3,2013,2015,2,0.3
Anthony Bennett ,69,1,3,2013,2016,3,0.1
Anthony Bonner ,70,23,6,1990,1991,1,0.7
Anthony Bonner ,70,23,6,1990,1992,2,1.6
Anthony Bonner ,70,23,6,1990,1993,3,2.4
Anthony Bonner ,70,23,6,1990,1994,4,4.1
Anthony Bonner ,70,23,6,1990,1995,5,1.8
Anthony Bonner ,70,23,6,1990,1996,6,0
Anthony Brown ,71,34,1,2015,2016,1,-0.3
Anthony Cook ,72,24,4,1989,1991,2,0.5
Anthony Cook ,72,24,4,1989,1992,3,0.4
Anthony Cook ,72,24,4,1989,1994,5,0.1
Anthony Cook ,72,24,4,1989,1996,7,0.1
Anthony Davis ,73,1,4,2012,2013,1,6.1
Anthony Davis ,73,1,4,2012,2014,2,10.4
Anthony Davis ,73,1,4,2012,2015,3,14
Anthony Davis ,73,1,4,2012,2016,4,7.2
Anthony Johnson ,74,39,13,1997,1998,1,0.4
Anthony Johnson ,74,39,13,1997,1999,2,1.1
Anthony Johnson ,74,39,13,1997,2000,3,0.3
Anthony Johnson ,74,39,13,1997,2001,4,-0.2
Anthony Johnson ,74,39,13,1997,2002,5,0.7
Anthony Johnson ,74,39,13,1997,2003,6,1.8
Anthony Johnson ,74,39,13,1997,2004,7,3.6
Anthony Johnson ,74,39,13,1997,2005,8,4
Anthony Johnson ,74,39,13,1997,2006,9,4.5
Anthony Johnson ,74,39,13,1997,2007,10,1.2
Anthony Johnson ,74,39,13,1997,2008,11,2
Anthony Johnson ,74,39,13,1997,2009,12,2.8
Anthony Johnson ,74,39,13,1997,2010,13,1
Anthony Jones ,75,21,3,1986,1987,1,0.5
Anthony Jones ,75,21,3,1986,1989,3,0.3
Anthony Jones ,75,21,3,1986,1990,4,0
Anthony Miller ,76,39,8,1994,1995,1,1.2
Anthony Miller ,76,39,8,1994,1996,2,0
Anthony Miller ,76,39,8,1994,1997,3,-0.1
Anthony Miller ,76,39,8,1994,1998,4,0.8
Anthony Miller ,76,39,8,1994,1999,5,0.6
Anthony Miller ,76,39,8,1994,2000,6,1.2
Anthony Miller ,76,39,8,1994,2001,7,0
Anthony Miller ,76,39,8,1994,2005,11,0
Anthony Parker ,77,21,9,1997,1998,1,0.4
Anthony Parker ,77,21,9,1997,1999,2,0
Anthony Parker ,77,21,9,1997,2000,3,0.2
Anthony Parker ,77,21,9,1997,2007,10,6.5
Anthony Parker ,77,21,9,1997,2008,11,6.2
Anthony Parker ,77,21,9,1997,2009,12,3.4
Anthony Parker ,77,21,9,1997,2010,13,4.9
Anthony Parker ,77,21,9,1997,2011,14,1.5
Anthony Parker ,77,21,9,1997,2012,15,1.4
Anthony Peeler ,78,15,13,1992,1993,1,2.7
Anthony Peeler ,78,15,13,1992,1994,2,0.8
Anthony Peeler ,78,15,13,1992,1995,3,2.4
Anthony Peeler ,78,15,13,1992,1996,4,3.7
Anthony Peeler ,78,15,13,1992,1997,5,0.6
Anthony Peeler ,78,15,13,1992,1998,6,2.5
Anthony Peeler ,78,15,13,1992,1999,7,1.1
Anthony Peeler ,78,15,13,1992,2000,8,4.1
Anthony Peeler ,78,15,13,1992,2001,9,3.2
Anthony Peeler ,78,15,13,1992,2002,10,3.8
Anthony Peeler ,78,15,13,1992,2003,11,3.4
Anthony Peeler ,78,15,13,1992,2004,12,2.2
Anthony Peeler ,78,15,13,1992,2005,13,0.5
Anthony Randolph ,79,14,6,2008,2009,1,1.6
Anthony Randolph ,79,14,6,2008,2010,2,1.5
Anthony Randolph ,79,14,6,2008,2011,3,0.5
Anthony Randolph ,79,14,6,2008,2012,4,1.1
Anthony Randolph ,79,14,6,2008,2013,5,0.5
Anthony Randolph ,79,14,6,2008,2014,6,0.6
Anthony Taylor ,80,44,1,1988,1989,1,0.2
Antoine Carr ,81,8,16,1983,1985,2,2.1
Antoine Carr ,81,8,16,1983,1986,3,0.7
Antoine Carr ,81,8,16,1983,1987,4,2.2
Antoine Carr ,81,8,16,1983,1988,5,3.8
Antoine Carr ,81,8,16,1983,1989,6,3.3
Antoine Carr ,81,8,16,1983,1990,7,3.5
Antoine Carr ,81,8,16,1983,1991,8,5.4
Antoine Carr ,81,8,16,1983,1992,9,4
Antoine Carr ,81,8,16,1983,1993,10,5.5
Antoine Carr ,81,8,16,1983,1994,11,1.2
Antoine Carr ,81,8,16,1983,1995,12,4.3
Antoine Carr ,81,8,16,1983,1996,13,2.1
Antoine Carr ,81,8,16,1983,1997,14,2.4
Antoine Carr ,81,8,16,1983,1998,15,1.5
Antoine Carr ,81,8,16,1983,1999,16,0
Antoine Carr ,81,8,16,1983,2000,17,0.1
Antoine Walker ,82,6,12,1996,1997,1,1.7
Antoine Walker ,82,6,12,1996,1998,2,4.7
Antoine Walker ,82,6,12,1996,1999,3,2.6
Antoine Walker ,82,6,12,1996,2000,4,5
Antoine Walker ,82,6,12,1996,2001,5,6.6
Antoine Walker ,82,6,12,1996,2002,6,6.7
Antoine Walker ,82,6,12,1996,2003,7,2.6
Antoine Walker ,82,6,12,1996,2004,8,3.9
Antoine Walker ,82,6,12,1996,2005,9,0.9
Antoine Walker ,82,6,12,1996,2006,10,3.6
Antoine Walker ,82,6,12,1996,2007,11,-0.3
Antoine Walker ,82,6,12,1996,2008,12,0.1
Antoine Wright ,83,15,6,2005,2006,1,-0.5
Antoine Wright ,83,15,6,2005,2007,2,1.2
Antoine Wright ,83,15,6,2005,2008,3,0.8
Antoine Wright ,83,15,6,2005,2009,4,1.4
Antoine Wright ,83,15,6,2005,2010,5,0.3
Antoine Wright ,83,15,6,2005,2011,6,-0.1
Antonio Burks ,84,36,2,2004,2005,1,0.5
Antonio Burks ,84,36,2,2004,2006,2,-0.4
Antonio Daniels ,85,4,13,1997,1998,1,-1.3
Antonio Daniels ,85,4,13,1997,1999,2,1.8
Antonio Daniels ,85,4,13,1997,2000,3,3.6
Antonio Daniels ,85,4,13,1997,2001,4,6.6
Antonio Daniels ,85,4,13,1997,2002,5,5.9
Antonio Daniels ,85,4,13,1997,2003,6,2.3
Antonio Daniels ,85,4,13,1997,2004,7,5.8
Antonio Daniels ,85,4,13,1997,2005,8,6.8
Antonio Daniels ,85,4,13,1997,2006,9,5.3
Antonio Daniels ,85,4,13,1997,2007,10,4.3
Antonio Daniels ,85,4,13,1997,2008,11,4.5
Antonio Daniels ,85,4,13,1997,2009,12,1.5
Antonio Daniels ,85,4,13,1997,2011,14,0
Antonio Davis ,86,45,13,1990,1994,4,5
Antonio Davis ,86,45,13,1990,1995,5,2
Antonio Davis ,86,45,13,1990,1996,6,6
Antonio Davis ,86,45,13,1990,1997,7,5.2
Antonio Davis ,86,45,13,1990,1998,8,7.4
Antonio Davis ,86,45,13,1990,1999,9,4
Antonio Davis ,86,45,13,1990,2000,10,6.1
Antonio Davis ,86,45,13,1990,2001,11,7.2
Antonio Davis ,86,45,13,1990,2002,12,6.5
Antonio Davis ,86,45,13,1990,2003,13,2.2
Antonio Davis ,86,45,13,1990,2004,14,3.8
Antonio Davis ,86,45,13,1990,2005,15,3.9
Antonio Davis ,86,45,13,1990,2006,16,0.3
Antonio Lang ,87,29,6,1994,1995,1,-0.1
Antonio Lang ,87,29,6,1994,1996,2,0.7
Antonio Lang ,87,29,6,1994,1997,3,0.8
Antonio Lang ,87,29,6,1994,1998,4,0.1
Antonio Lang ,87,29,6,1994,1999,5,0.1
Antonio Lang ,87,29,6,1994,2000,6,0
Antonio McDyess ,88,2,15,1995,1996,1,3.6
Antonio McDyess ,88,2,15,1995,1997,2,1.8
Antonio McDyess ,88,2,15,1995,1998,3,9.4
Antonio McDyess ,88,2,15,1995,1999,4,4.2
Antonio McDyess ,88,2,15,1995,2000,5,6.2
Antonio McDyess ,88,2,15,1995,2001,6,7.8
Antonio McDyess ,88,2,15,1995,2002,7,0.8
Antonio McDyess ,88,2,15,1995,2004,9,1.2
Antonio McDyess ,88,2,15,1995,2005,10,5.7
Antonio McDyess ,88,2,15,1995,2006,11,4.6
Antonio McDyess ,88,2,15,1995,2007,12,6
Antonio McDyess ,88,2,15,1995,2008,13,6.7
Antonio McDyess ,88,2,15,1995,2009,14,5.6
Antonio McDyess ,88,2,15,1995,2010,15,3.2
Antonio McDyess ,88,2,15,1995,2011,16,3
Antonis Fotsis ,89,47,1,2001,2002,1,0.1
Archie Goodwin ,90,29,3,2013,2014,1,0.2
Archie Goodwin ,90,29,3,2013,2015,2,0.2
Archie Goodwin ,90,29,3,2013,2016,3,0.1
Armen Gilliam ,91,2,13,1987,1988,1,1.3
Armen Gilliam ,91,2,13,1987,1989,2,5.1
Armen Gilliam ,91,2,13,1987,1990,3,4.5
Armen Gilliam ,91,2,13,1987,1991,4,4.6
Armen Gilliam ,91,2,13,1987,1992,5,7.6
Armen Gilliam ,91,2,13,1987,1993,6,2.8
Armen Gilliam ,91,2,13,1987,1994,7,6.8
Armen Gilliam ,91,2,13,1987,1995,8,6.6
Armen Gilliam ,91,2,13,1987,1996,9,6.7
Armen Gilliam ,91,2,13,1987,1997,10,4.1
Armen Gilliam ,91,2,13,1987,1998,11,5.3
Armen Gilliam ,91,2,13,1987,1999,12,1.5
Armen Gilliam ,91,2,13,1987,2000,13,1.2
Armon Johnson ,92,34,2,2010,2011,1,-0.3
Armon Johnson ,92,34,2,2010,2012,2,0.1
Arnett Moultrie ,93,27,2,2012,2013,1,1.7
Arnett Moultrie ,93,27,2,2012,2014,2,0
Arron Afflalo ,94,27,9,2007,2008,1,1.9
Arron Afflalo ,94,27,9,2007,2009,2,1.8
Arron Afflalo ,94,27,9,2007,2010,3,4.3
Arron Afflalo ,94,27,9,2007,2011,4,6.2
Arron Afflalo ,94,27,9,2007,2012,5,5.3
Arron Afflalo ,94,27,9,2007,2013,6,2
Arron Afflalo ,94,27,9,2007,2014,7,5.3
Arron Afflalo ,94,27,9,2007,2015,8,2.6
Arron Afflalo ,94,27,9,2007,2016,9,2.7
Arvid Kramer ,95,45,1,1979,1980,1,-0.1
Audie Norris ,96,37,3,1982,1983,1,-0.1
Audie Norris ,96,37,3,1982,1984,2,1.1
Audie Norris ,96,37,3,1982,1985,3,1.9
Austin Croshere ,97,12,12,1997,1998,1,0
Austin Croshere ,97,12,12,1997,1999,2,0.3
Austin Croshere ,97,12,12,1997,2000,3,5.4
Austin Croshere ,97,12,12,1997,2001,4,3.2
Austin Croshere ,97,12,12,1997,2002,5,2.6
Austin Croshere ,97,12,12,1997,2003,6,2
Austin Croshere ,97,12,12,1997,2004,7,3.4
Austin Croshere ,97,12,12,1997,2005,8,4.1
Austin Croshere ,97,12,12,1997,2006,9,4.1
Austin Croshere ,97,12,12,1997,2007,10,1.3
Austin Croshere ,97,12,12,1997,2008,11,1.1
Austin Croshere ,97,12,12,1997,2009,12,0.1
Austin Daye ,98,15,6,2009,2010,1,1.3
Austin Daye ,98,15,6,2009,2011,2,2.1
Austin Daye ,98,15,6,2009,2012,3,-0.6
Austin Daye ,98,15,6,2009,2013,4,1.6
Austin Daye ,98,15,6,2009,2014,5,0.1
Austin Daye ,98,15,6,2009,2015,6,0
Austin Rivers ,99,10,4,2012,2013,1,-1.1
Austin Rivers ,99,10,4,2012,2014,2,0.6
Austin Rivers ,99,10,4,2012,2015,3,1.5
Austin Rivers ,99,10,4,2012,2016,4,1.9
Avery Bradley ,100,19,6,2010,2011,1,-0.5
Avery Bradley ,100,19,6,2010,2012,2,2.4
Avery Bradley ,100,19,6,2010,2013,3,0.4
Avery Bradley ,100,19,6,2010,2014,4,1.8
Avery Bradley ,100,19,6,2010,2015,5,2.5
Avery Bradley ,100,19,6,2010,2016,6,4.8
B.J. Armstrong ,101,18,11,1989,1990,1,1.7
B.J. Armstrong ,101,18,11,1989,1991,2,4.1
B.J. Armstrong ,101,18,11,1989,1992,3,4.6
B.J. Armstrong ,101,18,11,1989,1993,4,7.5
B.J. Armstrong ,101,18,11,1989,1994,5,7.5
B.J. Armstrong ,101,18,11,1989,1995,6,8.1
B.J. Armstrong ,101,18,11,1989,1996,7,7
B.J. Armstrong ,101,18,11,1989,1997,8,1.3
B.J. Armstrong ,101,18,11,1989,1998,9,2.2
B.J. Armstrong ,101,18,11,1989,1999,10,0.7
B.J. Armstrong ,101,18,11,1989,2000,11,0.4
B.J. Tyler ,102,20,1,1994,1995,1,-0.7
Baron Davis ,103,3,13,1999,2000,1,2.1
Baron Davis ,103,3,13,1999,2001,2,8.9
Baron Davis ,103,3,13,1999,2002,3,8.2
Baron Davis ,103,3,13,1999,2003,4,4.5
Baron Davis ,103,3,13,1999,2004,5,7.5
Baron Davis ,103,3,13,1999,2005,6,4.4
Baron Davis ,103,3,13,1999,2006,7,4.4
Baron Davis ,103,3,13,1999,2007,8,6.4
Baron Davis ,103,3,13,1999,2008,9,8.7
Baron Davis ,103,3,13,1999,2009,10,0.6
Baron Davis ,103,3,13,1999,2010,11,4.5
Baron Davis ,103,3,13,1999,2011,12,2.8
Baron Davis ,103,3,13,1999,2012,13,0.2
Barry Stevens ,104,43,1,1985,1993,8,0
Ben Coleman ,105,37,5,1984,1987,3,2
Ben Coleman ,105,37,5,1984,1988,4,1.8
Ben Coleman ,105,37,5,1984,1989,5,0.8
Ben Coleman ,105,37,5,1984,1990,6,0.5
Ben Coleman ,105,37,5,1984,1994,10,0
Ben Davis ,106,43,4,1996,1997,1,0.1
Ben Davis ,106,43,4,1996,1998,2,0
Ben Davis ,106,43,4,1996,1999,3,0.1
Ben Davis ,106,43,4,1996,2000,4,0
Ben Gordon ,107,3,11,2004,2005,1,3.5
Ben Gordon ,107,3,11,2004,2006,2,4.4
Ben Gordon ,107,3,11,2004,2007,3,8.6
Ben Gordon ,107,3,11,2004,2008,4,5.1
Ben Gordon ,107,3,11,2004,2009,5,6.9
Ben Gordon ,107,3,11,2004,2010,6,2.1
Ben Gordon ,107,3,11,2004,2011,7,1.7
Ben Gordon ,107,3,11,2004,2012,8,1.7
Ben Gordon ,107,3,11,2004,2013,9,-0.6
Ben Gordon ,107,3,11,2004,2014,10,-0.3
Ben Gordon ,107,3,11,2004,2015,11,0.3
Ben McDonald ,108,50,4,1984,1986,2,0.2
Ben McDonald ,108,50,4,1984,1987,3,0.7
Ben McDonald ,108,50,4,1984,1988,4,1.3
Ben McDonald ,108,50,4,1984,1989,5,0.3
Ben McLemore ,109,7,3,2013,2014,1,0.8
Ben McLemore ,109,7,3,2013,2015,2,2.5
Ben McLemore ,109,7,3,2013,2016,3,0.3
Beno Udrih ,110,28,12,2004,2005,1,3.1
Beno Udrih ,110,28,12,2004,2006,2,1.3
Beno Udrih ,110,28,12,2004,2007,3,1
Beno Udrih ,110,28,12,2004,2008,4,2.4
Beno Udrih ,110,28,12,2004,2009,5,1.2
Beno Udrih ,110,28,12,2004,2010,6,5.5
Beno Udrih ,110,28,12,2004,2011,7,7.2
Beno Udrih ,110,28,12,2004,2012,8,1.4
Beno Udrih ,110,28,12,2004,2013,9,2.2
Beno Udrih ,110,28,12,2004,2014,10,0.8
Beno Udrih ,110,28,12,2004,2015,11,3.6
Beno Udrih ,110,28,12,2004,2016,12,0.4
Benoit Benjamin ,111,3,15,1985,1986,1,4
Benoit Benjamin ,111,3,15,1985,1987,2,1.1
Benoit Benjamin ,111,3,15,1985,1988,3,2
Benoit Benjamin ,111,3,15,1985,1989,4,5.1
Benoit Benjamin ,111,3,15,1985,1990,5,5.4
Benoit Benjamin ,111,3,15,1985,1991,6,3
Benoit Benjamin ,111,3,15,1985,1992,7,2.2
Benoit Benjamin ,111,3,15,1985,1993,8,0.9
Benoit Benjamin ,111,3,15,1985,1994,9,4.1
Benoit Benjamin ,111,3,15,1985,1995,10,2.2
Benoit Benjamin ,111,3,15,1985,1996,11,2.3
Benoit Benjamin ,111,3,15,1985,1997,12,0
Benoit Benjamin ,111,3,15,1985,1998,13,0.4
Benoit Benjamin ,111,3,15,1985,1999,14,-0.1
Benoit Benjamin ,111,3,15,1985,2000,15,0
Bernard James ,112,33,3,2012,2013,1,1.2
Bernard James ,112,33,3,2012,2014,2,0.1
Bernard James ,112,33,3,2012,2015,3,0.5
Bernard Robinson ,113,45,3,2004,2005,1,0.3
Bernard Robinson ,113,45,3,2004,2006,2,1.7
Bernard Robinson ,113,45,3,2004,2007,3,0.1
Bernard Thompson ,114,19,5,1984,1985,1,0.2
Bernard Thompson ,114,19,5,1984,1986,2,2.1
Bernard Thompson ,114,19,5,1984,1987,3,0.1
Bernard Thompson ,114,19,5,1984,1988,4,0.9
Bernard Thompson ,114,19,5,1984,1989,5,0
Bernard Toone ,115,37,1,1979,1980,1,-0.1
Bill Cartwright ,116,3,15,1979,1980,1,9.7
Bill Cartwright ,116,3,15,1979,1981,2,10
Bill Cartwright ,116,3,15,1979,1982,3,5
Bill Cartwright ,116,3,15,1979,1983,4,10.1
Bill Cartwright ,116,3,15,1979,1984,5,9.8
Bill Cartwright ,116,3,15,1979,1986,7,0
Bill Cartwright ,116,3,15,1979,1987,8,5.8
Bill Cartwright ,116,3,15,1979,1988,9,6.4
Bill Cartwright ,116,3,15,1979,1989,10,2.1
Bill Cartwright ,116,3,15,1979,1990,11,4.5
Bill Cartwright ,116,3,15,1979,1991,12,4.2
Bill Cartwright ,116,3,15,1979,1992,13,2.5
Bill Cartwright ,116,3,15,1979,1993,14,1.2
Bill Cartwright ,116,3,15,1979,1994,15,1.3
Bill Cartwright ,116,3,15,1979,1995,16,0.2
Bill Curley ,117,22,5,1994,1995,1,0.5
Bill Curley ,117,22,5,1994,1998,4,0.2
Bill Curley ,117,22,5,1994,1999,5,0.7
Bill Curley ,117,22,5,1994,2000,6,0
Bill Curley ,117,22,5,1994,2001,7,0.2
Bill Garnett ,118,4,4,1982,1983,1,3.9
Bill Garnett ,118,4,4,1982,1984,2,3.5
Bill Garnett ,118,4,4,1982,1985,3,1.5
Bill Garnett ,118,4,4,1982,1986,4,2
Bill Hanzlik ,119,20,10,1980,1981,1,2.4
Bill Hanzlik ,119,20,10,1980,1982,2,4.1
Bill Hanzlik ,119,20,10,1980,1983,3,1
Bill Hanzlik ,119,20,10,1980,1984,4,1.9
Bill Hanzlik ,119,20,10,1980,1985,5,2.2
Bill Hanzlik ,119,20,10,1980,1986,6,4.7
Bill Hanzlik ,119,20,10,1980,1987,7,3.5
Bill Hanzlik ,119,20,10,1980,1988,8,1.3
Bill Hanzlik ,119,20,10,1980,1989,9,0.7
Bill Hanzlik ,119,20,10,1980,1990,10,2.9
Bill Martin ,120,26,3,1985,1986,1,0.6
Bill Martin ,120,26,3,1985,1987,2,-0.1
Bill Martin ,120,26,3,1985,1988,3,-0.2
Bill Wennington ,121,16,13,1985,1986,1,0.9
Bill Wennington ,121,16,13,1985,1987,2,0.5
Bill Wennington ,121,16,13,1985,1988,3,0.4
Bill Wennington ,121,16,13,1985,1989,4,1.3
Bill Wennington ,121,16,13,1985,1990,5,1.2
Bill Wennington ,121,16,13,1985,1991,6,2.1
Bill Wennington ,121,16,13,1985,1994,9,3.5
Bill Wennington ,121,16,13,1985,1995,10,2.3
Bill Wennington ,121,16,13,1985,1996,11,2.8
Bill Wennington ,121,16,13,1985,1997,12,2
Bill Wennington ,121,16,13,1985,1998,13,0.8
Bill Wennington ,121,16,13,1985,1999,14,-0.3
Bill Wennington ,121,16,13,1985,2000,15,0.1
Billy Owens ,122,3,10,1991,1992,1,5.6
Billy Owens ,122,3,10,1991,1993,2,2.2
Billy Owens ,122,3,10,1991,1994,3,5.7
Billy Owens ,122,3,10,1991,1995,4,3.2
Billy Owens ,122,3,10,1991,1996,5,3.2
Billy Owens ,122,3,10,1991,1997,6,2.8
Billy Owens ,122,3,10,1991,1998,7,3.7
Billy Owens ,122,3,10,1991,1999,8,0.2
Billy Owens ,122,3,10,1991,2000,9,1.2
Billy Owens ,122,3,10,1991,2001,10,0.8
Billy Ray Bates ,123,47,4,1978,1980,2,0.9
Billy Ray Bates ,123,47,4,1978,1981,3,3.6
Billy Ray Bates ,123,47,4,1978,1982,4,2.4
Billy Ray Bates ,123,47,4,1978,1983,5,0
Billy Thompson ,124,19,6,1986,1987,1,1.6
Billy Thompson ,124,19,6,1986,1988,2,-0.1
Billy Thompson ,124,19,6,1986,1989,3,2.8
Billy Thompson ,124,19,6,1986,1990,4,3.6
Billy Thompson ,124,19,6,1986,1991,5,1.7
Billy Thompson ,124,19,6,1986,1992,6,0
Bimbo Coles ,125,40,14,1990,1991,1,1.1
Bimbo Coles ,125,40,14,1990,1992,2,3
Bimbo Coles ,125,40,14,1990,1993,3,5.7
Bimbo Coles ,125,40,14,1990,1994,4,3.2
Bimbo Coles ,125,40,14,1990,1995,5,2.8
Bimbo Coles ,125,40,14,1990,1996,6,5
Bimbo Coles ,125,40,14,1990,1997,7,0.5
Bimbo Coles ,125,40,14,1990,1998,8,0.9
Bimbo Coles ,125,40,14,1990,1999,9,2.7
Bimbo Coles ,125,40,14,1990,2000,10,2.3
Bimbo Coles ,125,40,14,1990,2001,11,0
Bimbo Coles ,125,40,14,1990,2002,12,0.4
Bimbo Coles ,125,40,14,1990,2003,13,0
Bimbo Coles ,125,40,14,1990,2004,14,-0.1
Bismack Biyombo ,126,7,5,2011,2012,1,0.6
Bismack Biyombo ,126,7,5,2011,2013,2,1.4
Bismack Biyombo ,126,7,5,2011,2014,3,3.2
Bismack Biyombo ,126,7,5,2011,2015,4,4
Bismack Biyombo ,126,7,5,2011,2016,5,5.9
Bison Dele ,127,10,8,1991,1992,1,1.8
Bison Dele ,127,10,8,1991,1993,2,0.3
Bison Dele ,127,10,8,1991,1994,3,4.7
Bison Dele ,127,10,8,1991,1995,4,2.3
Bison Dele ,127,10,8,1991,1996,5,4
Bison Dele ,127,10,8,1991,1997,6,0.2
Bison Dele ,127,10,8,1991,1998,7,6.9
Bison Dele ,127,10,8,1991,1999,8,2.4
Blair Rasmussen ,128,15,8,1985,1986,1,-0.1
Blair Rasmussen ,128,15,8,1985,1987,2,3.3
Blair Rasmussen ,128,15,8,1985,1988,3,4.2
Blair Rasmussen ,128,15,8,1985,1989,4,1.8
Blair Rasmussen ,128,15,8,1985,1990,5,5.2
Blair Rasmussen ,128,15,8,1985,1991,6,1.7
Blair Rasmussen ,128,15,8,1985,1992,7,3
Blair Rasmussen ,128,15,8,1985,1993,8,0
Blake Griffin ,129,1,6,2009,2011,2,9.8
Blake Griffin ,129,1,6,2009,2012,3,9.2
Blake Griffin ,129,1,6,2009,2013,4,10.6
Blake Griffin ,129,1,6,2009,2014,5,12.2
Blake Griffin ,129,1,6,2009,2015,6,9
Blake Griffin ,129,1,6,2009,2016,7,3.8
Blue Edwards ,130,21,10,1989,1990,1,2.7
Blue Edwards ,130,21,10,1989,1991,2,2.2
Blue Edwards ,130,21,10,1989,1992,3,5.2
Blue Edwards ,130,21,10,1989,1993,4,5.7
Blue Edwards ,130,21,10,1989,1994,5,2.9
Blue Edwards ,130,21,10,1989,1995,6,1.2
Blue Edwards ,130,21,10,1989,1996,7,1.9
Blue Edwards ,130,21,10,1989,1997,8,-0.1
Blue Edwards ,130,21,10,1989,1998,9,2.1
Blue Edwards ,130,21,10,1989,1999,10,0.4
Bo Kimble ,131,8,3,1990,1991,1,0
Bo Kimble ,131,8,3,1990,1992,2,0.1
Bo Kimble ,131,8,3,1990,1993,3,0
Bob McCann ,132,32,5,1987,1990,3,0.1
Bob McCann ,132,32,5,1987,1992,5,0.1
Bob McCann ,132,32,5,1987,1993,6,1.3
Bob McCann ,132,32,5,1987,1996,9,0.6
Bob McCann ,132,32,5,1987,1998,11,0
Bob Sura ,133,17,10,1995,1996,1,1.6
Bob Sura ,133,17,10,1995,1997,2,5.2
Bob Sura ,133,17,10,1995,1998,3,0.7
Bob Sura ,133,17,10,1995,1999,4,0.4
Bob Sura ,133,17,10,1995,2000,5,4.9
Bob Sura ,133,17,10,1995,2001,6,0.1
Bob Sura ,133,17,10,1995,2002,7,4.1
Bob Sura ,133,17,10,1995,2003,8,1.8
Bob Sura ,133,17,10,1995,2004,9,4.6
Bob Sura ,133,17,10,1995,2005,10,4.8
Bobby Hurley ,134,7,5,1993,1994,1,-0.5
Bobby Hurley ,134,7,5,1993,1995,2,-0.3
Bobby Hurley ,134,7,5,1993,1996,3,-0.3
Bobby Hurley ,134,7,5,1993,1997,4,0.4
Bobby Hurley ,134,7,5,1993,1998,5,-0.5
Bobby Jackson ,135,23,12,1997,1998,1,-0.6
Bobby Jackson ,135,23,12,1997,1999,2,1.2
Bobby Jackson ,135,23,12,1997,2000,3,2.2
Bobby Jackson ,135,23,12,1997,2001,4,3.1
Bobby Jackson ,135,23,12,1997,2002,5,5.4
Bobby Jackson ,135,23,12,1997,2003,6,5.5
Bobby Jackson ,135,23,12,1997,2004,7,3.1
Bobby Jackson ,135,23,12,1997,2005,8,1.4
Bobby Jackson ,135,23,12,1997,2006,9,3.5
Bobby Jackson ,135,23,12,1997,2007,10,2.5
Bobby Jackson ,135,23,12,1997,2008,11,3
Bobby Jackson ,135,23,12,1997,2009,12,1.2
Bobby Jones ,136,37,2,2006,2007,1,0.3
Bobby Jones ,136,37,2,2006,2008,2,0.8
Bobby JonesSr.,137,5,12,1976,1977,1,10.2
Bobby JonesSr.,137,5,12,1976,1978,2,9.2
Bobby JonesSr.,137,5,12,1976,1979,3,8.9
Bobby JonesSr.,137,5,12,1976,1980,4,8.2
Bobby JonesSr.,137,5,12,1976,1981,5,8.1
Bobby JonesSr.,137,5,12,1976,1982,6,7.7
Bobby JonesSr.,137,5,12,1976,1983,7,6.4
Bobby JonesSr.,137,5,12,1976,1984,8,6
Bobby JonesSr.,137,5,12,1976,1985,9,4.8
Bobby JonesSr.,137,5,12,1976,1986,10,3.2
Bobby Phills ,138,45,9,1991,1994,3,3.5
Bobby Phills ,138,45,9,1991,1995,4,4
Bobby Phills ,138,45,9,1991,1996,5,7.1
Bobby Phills ,138,45,9,1991,1997,6,5
Bobby Phills ,138,45,9,1991,1998,7,3.2
Bobby Phills ,138,45,9,1991,1999,8,3
Bobby Phills ,138,45,9,1991,2000,9,1.5
Bobby Portis ,139,22,1,2015,2016,1,1.5
Bobby Simmons ,140,41,10,2001,2002,1,0.7
Bobby Simmons ,140,41,10,2001,2003,2,0.9
Bobby Simmons ,140,41,10,2001,2004,3,2
Bobby Simmons ,140,41,10,2001,2005,4,6.8
Bobby Simmons ,140,41,10,2001,2006,5,5.3
Bobby Simmons ,140,41,10,2001,2008,7,0.7
Bobby Simmons ,140,41,10,2001,2009,8,3.4
Bobby Simmons ,140,41,10,2001,2010,9,0.1
Bobby Simmons ,140,41,10,2001,2011,10,0
Bobby Simmons ,140,41,10,2001,2012,11,0.3
Bojan Bogdanovic ,141,31,2,2011,2015,4,2.4
Bojan Bogdanovic ,141,31,2,2011,2016,5,0.9
Bonzi Wells ,142,11,10,1998,1999,1,0.1
Bonzi Wells ,142,11,10,1998,2000,2,3.1
Bonzi Wells ,142,11,10,1998,2001,3,5.9
Bonzi Wells ,142,11,10,1998,2002,4,6
Bonzi Wells ,142,11,10,1998,2003,5,4
Bonzi Wells ,142,11,10,1998,2004,6,0.9
Bonzi Wells ,142,11,10,1998,2005,7,3.1
Bonzi Wells ,142,11,10,1998,2006,8,3.4
Bonzi Wells ,142,11,10,1998,2007,9,-0.1
Bonzi Wells ,142,11,10,1998,2008,10,3
Boris Diaw ,143,21,13,2003,2004,1,0.8
Boris Diaw ,143,21,13,2003,2005,2,0.1
Boris Diaw ,143,21,13,2003,2006,3,8.9
Boris Diaw ,143,21,13,2003,2007,4,4.6
Boris Diaw ,143,21,13,2003,2008,5,3
Boris Diaw ,143,21,13,2003,2009,6,4.7
Boris Diaw ,143,21,13,2003,2010,7,6.2
Boris Diaw ,143,21,13,2003,2011,8,4.8
Boris Diaw ,143,21,13,2003,2012,9,0.6
Boris Diaw ,143,21,13,2003,2013,10,4.4
Boris Diaw ,143,21,13,2003,2014,11,4.9
Boris Diaw ,143,21,13,2003,2015,12,3.6
Boris Diaw ,143,21,13,2003,2016,13,3.8
Bostjan Nachbar ,144,15,6,2002,2003,1,-0.1
Bostjan Nachbar ,144,15,6,2002,2004,2,0.8
Bostjan Nachbar ,144,15,6,2002,2005,3,1.7
Bostjan Nachbar ,144,15,6,2002,2006,4,0.1
Bostjan Nachbar ,144,15,6,2002,2007,5,4.1
Bostjan Nachbar ,144,15,6,2002,2008,6,2.2
Bracey Wright ,145,47,2,2005,2006,1,0.2
Bracey Wright ,145,47,2,2005,2007,2,0.3
Brad Branson ,146,45,2,1980,1982,2,-0.1
Brad Branson ,146,45,2,1980,1983,3,1
Brad Daugherty ,147,1,8,1986,1987,1,6
Brad Daugherty ,147,1,8,1986,1988,2,6.6
Brad Daugherty ,147,1,8,1986,1989,3,9.6
Brad Daugherty ,147,1,8,1986,1990,4,3.1
Brad Daugherty ,147,1,8,1986,1991,5,9
Brad Daugherty ,147,1,8,1986,1992,6,11.7
Brad Daugherty ,147,1,8,1986,1993,7,12.7
Brad Daugherty ,147,1,8,1986,1994,8,6.4
Brad Holland ,148,14,3,1979,1980,1,0.3
Brad Holland ,148,14,3,1979,1981,2,0.1
Brad Holland ,148,14,3,1979,1982,3,-0.1
Brad Lohaus ,149,45,11,1987,1988,1,0.9
Brad Lohaus ,149,45,11,1987,1989,2,0.9
Brad Lohaus ,149,45,11,1987,1990,3,3.3
Brad Lohaus ,149,45,11,1987,1991,4,1.8
Brad Lohaus ,149,45,11,1987,1992,5,2.7
Brad Lohaus ,149,45,11,1987,1993,6,2.7
Brad Lohaus ,149,45,11,1987,1994,7,0.1
Brad Lohaus ,149,45,11,1987,1995,8,1.5
Brad Lohaus ,149,45,11,1987,1996,9,1.3
Brad Lohaus ,149,45,11,1987,1997,10,-0.1
Brad Lohaus ,149,45,11,1987,1998,11,0.1
Brad Sellers ,150,9,6,1986,1987,1,3.3
Brad Sellers ,150,9,6,1986,1988,2,3.3
Brad Sellers ,150,9,6,1986,1989,3,2.6
Brad Sellers ,150,9,6,1986,1990,4,0.2
Brad Sellers ,150,9,6,1986,1992,6,0.4
Brad Sellers ,150,9,6,1986,1993,7,0
Brad Wright ,151,49,2,1985,1987,2,0
Brad Wright ,151,49,2,1985,1988,3,-0.1
Bradley Beal ,152,3,4,2012,2013,1,3
Bradley Beal ,152,3,4,2012,2014,2,4
Bradley Beal ,152,3,4,2012,2015,3,3.7
Bradley Beal ,152,3,4,2012,2016,4,2.7
Brandan Wright ,153,8,8,2007,2008,1,1.1
Brandan Wright ,153,8,8,2007,2009,2,1.9
Brandan Wright ,153,8,8,2007,2011,4,0.8
Brandan Wright ,153,8,8,2007,2012,5,3.5
Brandan Wright ,153,8,8,2007,2013,6,4.1
Brandan Wright ,153,8,8,2007,2014,7,5.1
Brandan Wright ,153,8,8,2007,2015,8,6.1
Brandan Wright ,153,8,8,2007,2016,9,0.7
Brandon Armstrong ,154,23,3,2001,2002,1,-0.2
Brandon Armstrong ,154,23,3,2001,2003,2,-0.1
Brandon Armstrong ,154,23,3,2001,2004,3,-0.3
Brandon Bass ,155,33,11,2005,2006,1,0.1
Brandon Bass ,155,33,11,2005,2007,2,0
Brandon Bass ,155,33,11,2005,2008,3,4.3
Brandon Bass ,155,33,11,2005,2009,4,4.1
Brandon Bass ,155,33,11,2005,2010,5,2
Brandon Bass ,155,33,11,2005,2011,6,6.3
Brandon Bass ,155,33,11,2005,2012,7,4.7
Brandon Bass ,155,33,11,2005,2013,8,4.7
Brandon Bass ,155,33,11,2005,2014,9,5.1
Brandon Bass ,155,33,11,2005,2015,10,5.3
Brandon Bass ,155,33,11,2005,2016,11,4.1
Brandon Jennings ,156,10,7,2009,2010,1,4.2
Brandon Jennings ,156,10,7,2009,2011,2,3.9
Brandon Jennings ,156,10,7,2009,2012,3,5.5
Brandon Jennings ,156,10,7,2009,2013,4,5.8
Brandon Jennings ,156,10,7,2009,2014,5,3.9
Brandon Jennings ,156,10,7,2009,2015,6,3.3
Brandon Jennings ,156,10,7,2009,2016,7,1.5
Brandon Knight ,157,8,5,2011,2012,1,1.3
Brandon Knight ,157,8,5,2011,2013,2,1.1
Brandon Knight ,157,8,5,2011,2014,3,2.8
Brandon Knight ,157,8,5,2011,2015,4,4.5
Brandon Knight ,157,8,5,2011,2016,5,1.7
Brandon Roy ,158,6,6,2006,2007,1,4.8
Brandon Roy ,158,6,6,2006,2008,2,8
Brandon Roy ,158,6,6,2006,2009,3,13.5
Brandon Roy ,158,6,6,2006,2010,4,9.1
Brandon Roy ,158,6,6,2006,2011,5,2.1
Brandon Roy ,158,6,6,2006,2013,7,0
Brandon Rush ,159,13,8,2008,2009,1,0.9
Brandon Rush ,159,13,8,2008,2010,2,2.5
Brandon Rush ,159,13,8,2008,2011,3,2.6
Brandon Rush ,159,13,8,2008,2012,4,3.5
Brandon Rush ,159,13,8,2008,2013,5,0
Brandon Rush ,159,13,8,2008,2014,6,-0.4
Brandon Rush ,159,13,8,2008,2015,7,-0.3
Brandon Rush ,159,13,8,2008,2016,8,2
Brendan Haywood ,160,20,13,2001,2002,1,3.1
Brendan Haywood ,160,20,13,2001,2003,2,5
Brendan Haywood ,160,20,13,2001,2004,3,3.8
Brendan Haywood ,160,20,13,2001,2005,4,5.2
Brendan Haywood ,160,20,13,2001,2006,5,3.9
Brendan Haywood ,160,20,13,2001,2007,6,3.4
Brendan Haywood ,160,20,13,2001,2008,7,6.8
Brendan Haywood ,160,20,13,2001,2009,8,0.2
Brendan Haywood ,160,20,13,2001,2010,9,6.7
Brendan Haywood ,160,20,13,2001,2011,10,2.9
Brendan Haywood ,160,20,13,2001,2012,11,2.7
Brendan Haywood ,160,20,13,2001,2013,12,0.1
Brendan Haywood ,160,20,13,2001,2015,14,0
Brent Barry ,161,15,14,1995,1996,1,4.9
Brent Barry ,161,15,14,1995,1997,2,2.1
Brent Barry ,161,15,14,1995,1998,3,2.7
Brent Barry ,161,15,14,1995,1999,4,1.6
Brent Barry ,161,15,14,1995,2000,5,7.5
Brent Barry ,161,15,14,1995,2001,6,5.8
Brent Barry ,161,15,14,1995,2002,7,12.1
Brent Barry ,161,15,14,1995,2003,8,7.3
Brent Barry ,161,15,14,1995,2004,9,5.7
Brent Barry ,161,15,14,1995,2005,10,6.1
Brent Barry ,161,15,14,1995,2006,11,4.3
Brent Barry ,161,15,14,1995,2007,12,6.8
Brent Barry ,161,15,14,1995,2008,13,2.3
Brent Barry ,161,15,14,1995,2009,14,1.5
Brent Price ,162,32,9,1992,1993,1,-0.6
Brent Price ,162,32,9,1992,1994,2,0.7
Brent Price ,162,32,9,1992,1996,4,7.4
Brent Price ,162,32,9,1992,1997,5,0.7
Brent Price ,162,32,9,1992,1998,6,1.6
Brent Price ,162,32,9,1992,1999,7,2.2
Brent Price ,162,32,9,1992,2000,8,0.1
Brent Price ,162,32,9,1992,2001,9,0
Brent Price ,162,32,9,1992,2002,10,0
Brevin Knight ,163,16,12,1997,1998,1,8.4
Brevin Knight ,163,16,12,1997,1999,2,2.5
Brevin Knight ,163,16,12,1997,2000,3,2.8
Brevin Knight ,163,16,12,1997,2001,4,1.6
Brevin Knight ,163,16,12,1997,2002,5,1.4
Brevin Knight ,163,16,12,1997,2003,6,0.2
Brevin Knight ,163,16,12,1997,2004,7,1.7
Brevin Knight ,163,16,12,1997,2005,8,4.5
Brevin Knight ,163,16,12,1997,2006,9,4.9
Brevin Knight ,163,16,12,1997,2007,10,1.8
Brevin Knight ,163,16,12,1997,2008,11,2.1
Brevin Knight ,163,16,12,1997,2009,12,0.7
Brian Cardinal ,164,44,12,2000,2001,1,0
Brian Cardinal ,164,44,12,2000,2002,2,0.2
Brian Cardinal ,164,44,12,2000,2003,3,0
Brian Cardinal ,164,44,12,2000,2004,4,7.2
Brian Cardinal ,164,44,12,2000,2005,5,3.5
Brian Cardinal ,164,44,12,2000,2006,6,0.6
Brian Cardinal ,164,44,12,2000,2007,7,0.9
Brian Cardinal ,164,44,12,2000,2008,8,0
Brian Cardinal ,164,44,12,2000,2009,9,0.9
Brian Cardinal ,164,44,12,2000,2010,10,0.4
Brian Cardinal ,164,44,12,2000,2011,11,1.7
Brian Cardinal ,164,44,12,2000,2012,12,0
Brian Cook ,165,24,9,2003,2004,1,1.1
Brian Cook ,165,24,9,2003,2005,2,2
Brian Cook ,165,24,9,2003,2006,3,4.5
Brian Cook ,165,24,9,2003,2007,4,1.8
Brian Cook ,165,24,9,2003,2008,5,0.4
Brian Cook ,165,24,9,2003,2009,6,0
Brian Cook ,165,24,9,2003,2010,7,-0.2
Brian Cook ,165,24,9,2003,2011,8,0.6
Brian Cook ,165,24,9,2003,2012,9,-0.1
Brian Davis ,166,48,1,1992,1994,2,0
Brian Evans ,167,27,3,1996,1997,1,0.1
Brian Evans ,167,27,3,1996,1998,2,1.5
Brian Evans ,167,27,3,1996,1999,3,0.1
Brian Grant ,168,8,12,1994,1995,1,5.3
Brian Grant ,168,8,12,1994,1996,2,4.7
Brian Grant ,168,8,12,1994,1997,3,1
Brian Grant ,168,8,12,1994,1998,4,6.3
Brian Grant ,168,8,12,1994,1999,5,5.9
Brian Grant ,168,8,12,1994,2000,6,3.5
Brian Grant ,168,8,12,1994,2001,7,8.7
Brian Grant ,168,8,12,1994,2002,8,4.8
Brian Grant ,168,8,12,1994,2003,9,7.7
Brian Grant ,168,8,12,1994,2004,10,4.9
Brian Grant ,168,8,12,1994,2005,11,1.6
Brian Grant ,168,8,12,1994,2006,12,0.2
Brian Oliver ,169,32,4,1990,1991,1,0.2
Brian Oliver ,169,32,4,1990,1992,2,-0.7
Brian Oliver ,169,32,4,1990,1995,5,0
Brian Oliver ,169,32,4,1990,1998,8,0
Brian Quinnett ,170,50,3,1989,1990,1,-0.1
Brian Quinnett ,170,50,3,1989,1991,2,0.8
Brian Quinnett ,170,50,3,1989,1992,3,0.1
Brian Rowsom ,171,34,3,1987,1988,1,0
Brian Rowsom ,171,34,3,1987,1989,2,1.5
Brian Rowsom ,171,34,3,1987,1990,3,1
Brian Scalabrine ,172,34,11,2001,2002,1,-0.1
Brian Scalabrine ,172,34,11,2001,2003,2,1
Brian Scalabrine ,172,34,11,2001,2004,3,1.7
Brian Scalabrine ,172,34,11,2001,2005,4,1.4
Brian Scalabrine ,172,34,11,2001,2006,5,0.3
Brian Scalabrine ,172,34,11,2001,2007,6,0.9
Brian Scalabrine ,172,34,11,2001,2008,7,0.6
Brian Scalabrine ,172,34,11,2001,2009,8,1.1
Brian Scalabrine ,172,34,11,2001,2010,9,0.2
Brian Scalabrine ,172,34,11,2001,2011,10,0.1
Brian Scalabrine ,172,34,11,2001,2012,11,0.3
Brian Shaw ,173,24,14,1988,1989,1,2.2
Brian Shaw ,173,24,14,1988,1991,3,5.9
Brian Shaw ,173,24,14,1988,1992,4,1
Brian Shaw ,173,24,14,1988,1993,5,1.8
Brian Shaw ,173,24,14,1988,1994,6,3.2
Brian Shaw ,173,24,14,1988,1995,7,1.3
Brian Shaw ,173,24,14,1988,1996,8,0.6
Brian Shaw ,173,24,14,1988,1997,9,1.1
Brian Shaw ,173,24,14,1988,1998,10,0.1
Brian Shaw ,173,24,14,1988,1999,11,0
Brian Shaw ,173,24,14,1988,2000,12,2.1
Brian Shaw ,173,24,14,1988,2001,13,2.5
Brian Shaw ,173,24,14,1988,2002,14,1.2
Brian Shaw ,173,24,14,1988,2003,15,0.6
Brian Skinner ,174,22,14,1998,1999,1,0.1
Brian Skinner ,174,22,14,1998,2000,2,0.9
Brian Skinner ,174,22,14,1998,2001,3,0.3
Brian Skinner ,174,22,14,1998,2002,4,1.9
Brian Skinner ,174,22,14,1998,2003,5,4.1
Brian Skinner ,174,22,14,1998,2004,6,2.7
Brian Skinner ,174,22,14,1998,2005,7,1.9
Brian Skinner ,174,22,14,1998,2006,8,1.1
Brian Skinner ,174,22,14,1998,2007,9,1.1
Brian Skinner ,174,22,14,1998,2008,10,1.2
Brian Skinner ,174,22,14,1998,2009,11,0.4
Brian Skinner ,174,22,14,1998,2010,12,0
Brian Skinner ,174,22,14,1998,2011,13,0
Brian Skinner ,174,22,14,1998,2012,14,0
Brook Lopez ,175,10,8,2008,2009,1,5.8
Brook Lopez ,175,10,8,2008,2010,2,7.9
Brook Lopez ,175,10,8,2008,2011,3,6.3
Brook Lopez ,175,10,8,2008,2012,4,0.3
Brook Lopez ,175,10,8,2008,2013,5,9
Brook Lopez ,175,10,8,2008,2014,6,2.3
Brook Lopez ,175,10,8,2008,2015,7,7
Brook Lopez ,175,10,8,2008,2016,8,6.2
Brook Steppe ,176,17,5,1982,1983,1,1.1
Brook Steppe ,176,17,5,1982,1984,2,1.3
Brook Steppe ,176,17,5,1982,1985,3,1
Brook Steppe ,176,17,5,1982,1987,5,0.7
Brook Steppe ,176,17,5,1982,1989,7,0.6
Brooks Thompson ,177,27,4,1994,1995,1,0.1
Brooks Thompson ,177,27,4,1994,1996,2,0.6
Brooks Thompson ,177,27,4,1994,1997,3,1.1
Brooks Thompson ,177,27,4,1994,1998,4,0.2
Bruce Flowers ,178,26,1,1979,1983,4,1.7
Bruno Caboclo ,179,20,2,2014,2015,1,-0.1
Bruno Caboclo ,179,20,2,2014,2016,2,-0.3
Bruno Sundov ,180,35,7,1998,1999,1,-0.1
Bruno Sundov ,180,35,7,1998,2000,2,-0.1
Bruno Sundov ,180,35,7,1998,2001,3,0.2
Bruno Sundov ,180,35,7,1998,2002,4,0
Bruno Sundov ,180,35,7,1998,2003,5,-0.4
Bruno Sundov ,180,35,7,1998,2004,6,0
Bruno Sundov ,180,35,7,1998,2005,7,-0.3
Bryan Warrick ,181,25,4,1982,1983,1,0.1
Bryan Warrick ,181,25,4,1982,1984,2,0
Bryan Warrick ,181,25,4,1982,1985,3,0.5
Bryan Warrick ,181,25,4,1982,1986,4,1
Bryant Reeves ,182,6,6,1995,1996,1,2.3
Bryant Reeves ,182,6,6,1995,1997,2,2.4
Bryant Reeves ,182,6,6,1995,1998,3,4.9
Bryant Reeves ,182,6,6,1995,1999,4,-0.1
Bryant Reeves ,182,6,6,1995,2000,5,0.6
Bryant Reeves ,182,6,6,1995,2001,6,2.9
Bryant Stith ,183,13,10,1992,1993,1,1.6
Bryant Stith ,183,13,10,1992,1994,2,6.8
Bryant Stith ,183,13,10,1992,1995,3,5.6
Bryant Stith ,183,13,10,1992,1996,4,5.2
Bryant Stith ,183,13,10,1992,1997,5,3
Bryant Stith ,183,13,10,1992,1998,6,-0.3
Bryant Stith ,183,13,10,1992,1999,7,0.5
Bryant Stith ,183,13,10,1992,2000,8,1.6
Bryant Stith ,183,13,10,1992,2001,9,4.8
Bryant Stith ,183,13,10,1992,2002,10,0.7
Bryce Drew ,184,16,6,1998,1999,1,-0.1
Bryce Drew ,184,16,6,1998,2000,2,1.3
Bryce Drew ,184,16,6,1998,2001,3,-0.4
Bryce Drew ,184,16,6,1998,2002,4,1.7
Bryce Drew ,184,16,6,1998,2003,5,0
Bryce Drew ,184,16,6,1998,2004,6,-0.2
Bryon Russell ,185,45,13,1993,1994,1,2.1
Bryon Russell ,185,45,13,1993,1995,2,1.4
Bryon Russell ,185,45,13,1993,1996,3,0.8
Bryon Russell ,185,45,13,1993,1997,4,7.4
Bryon Russell ,185,45,13,1993,1998,5,6
Bryon Russell ,185,45,13,1993,1999,6,5.6
Bryon Russell ,185,45,13,1993,2000,7,8.8
Bryon Russell ,185,45,13,1993,2001,8,6.8
Bryon Russell ,185,45,13,1993,2002,9,2.3
Bryon Russell ,185,45,13,1993,2003,10,1.5
Bryon Russell ,185,45,13,1993,2004,11,2.2
Bryon Russell ,185,45,13,1993,2005,12,2.6
Bryon Russell ,185,45,13,1993,2006,13,0
Bubba Wells ,186,34,1,1997,1998,1,0.1
Buck Johnson ,187,20,7,1986,1987,1,0.7
Buck Johnson ,187,20,7,1986,1988,2,2.1
Buck Johnson ,187,20,7,1986,1989,3,3.6
Buck Johnson ,187,20,7,1986,1990,4,6.2
Buck Johnson ,187,20,7,1986,1991,5,4.6
Buck Johnson ,187,20,7,1986,1992,6,2.3
Buck Johnson ,187,20,7,1986,1993,7,1.2
Buck Williams ,188,3,17,1981,1982,1,8.9
Buck Williams ,188,3,17,1981,1983,2,11.4
Buck Williams ,188,3,17,1981,1984,3,7.3
Buck Williams ,188,3,17,1981,1985,4,7.7
Buck Williams ,188,3,17,1981,1986,5,6.8
Buck Williams ,188,3,17,1981,1987,6,7.9
Buck Williams ,188,3,17,1981,1988,7,7.6
Buck Williams ,188,3,17,1981,1989,8,5.2
Buck Williams ,188,3,17,1981,1990,9,8.7
Buck Williams ,188,3,17,1981,1991,10,8.5
Buck Williams ,188,3,17,1981,1992,11,9.2
Buck Williams ,188,3,17,1981,1993,12,6.1
Buck Williams ,188,3,17,1981,1994,13,7.9
Buck Williams ,188,3,17,1981,1995,14,6.1
Buck Williams ,188,3,17,1981,1996,15,3.9
Buck Williams ,188,3,17,1981,1997,16,4.8
Buck Williams ,188,3,17,1981,1998,17,2.1
Butch Carter ,189,37,6,1980,1981,1,0.9
Butch Carter ,189,37,6,1980,1982,2,1.3
Butch Carter ,189,37,6,1980,1983,3,3
Butch Carter ,189,37,6,1980,1984,4,2.6
Butch Carter ,189,37,6,1980,1985,5,0.9
Butch Carter ,189,37,6,1980,1986,6,-0.2
Butch Lee ,190,10,2,1978,1979,1,2.6
Butch Lee ,190,10,2,1978,1980,2,-0.2
Byron Houston ,191,27,4,1992,1993,1,1.8
Byron Houston ,191,27,4,1992,1994,2,0.9
Byron Houston ,191,27,4,1992,1995,3,0.5
Byron Houston ,191,27,4,1992,1996,4,0.7
Byron Irvin ,192,22,3,1989,1990,1,1.2
Byron Irvin ,192,22,3,1989,1991,2,0.9
Byron Irvin ,192,22,3,1989,1993,4,0
Byron Mullens ,193,24,5,2009,2010,1,-0.1
Byron Mullens ,193,24,5,2009,2011,2,-0.2
Byron Mullens ,193,24,5,2009,2012,3,0.2
Byron Mullens ,193,24,5,2009,2013,4,0.1
Byron Mullens ,193,24,5,2009,2014,5,0.5
Byron Scott ,194,4,14,1983,1984,1,2.7
Byron Scott ,194,4,14,1983,1985,2,6.9
Byron Scott ,194,4,14,1983,1986,3,5.2
Byron Scott ,194,4,14,1983,1987,4,7.7
Byron Scott ,194,4,14,1983,1988,5,10.7
Byron Scott ,194,4,14,1983,1989,6,6.8
Byron Scott ,194,4,14,1983,1990,7,6
Byron Scott ,194,4,14,1983,1991,8,6.6
Byron Scott ,194,4,14,1983,1992,9,6
Byron Scott ,194,4,14,1983,1993,10,3.3
Byron Scott ,194,4,14,1983,1994,11,3.1
Byron Scott ,194,4,14,1983,1995,12,3.9
Byron Scott ,194,4,14,1983,1996,13,2.3
Byron Scott ,194,4,14,1983,1997,14,4.1
C.J. McCollum ,195,10,3,2013,2014,1,0.2
C.J. McCollum ,195,10,3,2013,2015,2,1.8
C.J. McCollum ,195,10,3,2013,2016,3,6
C.J. Miles ,196,34,11,2005,2006,1,0.3
C.J. Miles ,196,34,11,2005,2007,2,-0.5
C.J. Miles ,196,34,11,2005,2008,3,1.9
C.J. Miles ,196,34,11,2005,2009,4,2.9
C.J. Miles ,196,34,11,2005,2010,5,1.9
C.J. Miles ,196,34,11,2005,2011,6,2.5
C.J. Miles ,196,34,11,2005,2012,7,1.5
C.J. Miles ,196,34,11,2005,2013,8,2.6
C.J. Miles ,196,34,11,2005,2014,9,2.5
C.J. Miles ,196,34,11,2005,2015,10,3.6
C.J. Miles ,196,34,11,2005,2016,11,3.1
C.J. Wilcox ,197,28,2,2014,2015,1,0
C.J. Wilcox ,197,28,2,2014,2016,2,0.3
Cal Bowdler ,198,17,3,1999,2000,1,0.2
Cal Bowdler ,198,17,3,1999,2001,2,1
Cal Bowdler ,198,17,3,1999,2002,3,0.5
Calbert Cheaney ,199,6,13,1993,1994,1,1.2
Calbert Cheaney ,199,6,13,1993,1995,2,3.2
Calbert Cheaney ,199,6,13,1993,1996,3,3.2
Calbert Cheaney ,199,6,13,1993,1997,4,3.9
Calbert Cheaney ,199,6,13,1993,1998,5,4.1
Calbert Cheaney ,199,6,13,1993,1999,6,0.4
Calbert Cheaney ,199,6,13,1993,2000,7,0.8
Calbert Cheaney ,199,6,13,1993,2001,8,-0.1
Calbert Cheaney ,199,6,13,1993,2002,9,1.2
Calbert Cheaney ,199,6,13,1993,2003,10,2.8
Calbert Cheaney ,199,6,13,1993,2004,11,2.3
Calbert Cheaney ,199,6,13,1993,2005,12,0.3
Calbert Cheaney ,199,6,13,1993,2006,13,0
Calvin Booth ,200,35,10,1999,2000,1,0.1
Calvin Booth ,200,35,10,1999,2001,2,2.1
Calvin Booth ,200,35,10,1999,2002,3,0.5
Calvin Booth ,200,35,10,1999,2003,4,0.8
Calvin Booth ,200,35,10,1999,2004,5,2.2
Calvin Booth ,200,35,10,1999,2005,6,1
Calvin Booth ,200,35,10,1999,2006,7,0.4
Calvin Booth ,200,35,10,1999,2007,8,0.6
Calvin Booth ,200,35,10,1999,2008,9,0.3
Calvin Booth ,200,35,10,1999,2009,10,0.1
Calvin Garrett ,201,47,4,1979,1981,2,1.4
Calvin Garrett ,201,47,4,1979,1982,3,0.6
Calvin Garrett ,201,47,4,1979,1983,4,0
Calvin Garrett ,201,47,4,1979,1984,5,0.6
Calvin Natt ,202,8,11,1979,1980,1,7.1
Calvin Natt ,202,8,11,1979,1981,2,4.2
Calvin Natt ,202,8,11,1979,1982,3,9.3
Calvin Natt ,202,8,11,1979,1983,4,9.8
Calvin Natt ,202,8,11,1979,1984,5,8.4
Calvin Natt ,202,8,11,1979,1985,6,10.2
Calvin Natt ,202,8,11,1979,1986,7,6.1
Calvin Natt ,202,8,11,1979,1987,8,0
Calvin Natt ,202,8,11,1979,1988,9,1.1
Calvin Natt ,202,8,11,1979,1989,10,0.3
Calvin Natt ,202,8,11,1979,1990,11,0.5
Cameron Bairstow ,203,49,2,2014,2015,1,-0.1
Cameron Bairstow ,203,49,2,2014,2016,2,0
Cameron Payne ,204,14,1,2015,2016,1,1.4
Carey Scurry ,205,37,3,1985,1986,1,1.8
Carey Scurry ,205,37,3,1985,1987,2,2.6
Carey Scurry ,205,37,3,1985,1988,3,0.9
Carl Herrera ,206,30,8,1990,1992,2,0.5
Carl Herrera ,206,30,8,1990,1993,3,4.6
Carl Herrera ,206,30,8,1990,1994,4,2
Carl Herrera ,206,30,8,1990,1995,5,2.1
Carl Herrera ,206,30,8,1990,1996,6,-0.2
Carl Herrera ,206,30,8,1990,1997,7,0.1
Carl Herrera ,206,30,8,1990,1998,8,0.1
Carl Herrera ,206,30,8,1990,1999,9,-0.3
Carl Landry ,207,31,9,2007,2008,1,3.7
Carl Landry ,207,31,9,2007,2009,2,5.9
Carl Landry ,207,31,9,2007,2010,3,7.7
Carl Landry ,207,31,9,2007,2011,4,4.1
Carl Landry ,207,31,9,2007,2012,5,2.9
Carl Landry ,207,31,9,2007,2013,6,6.2
Carl Landry ,207,31,9,2007,2014,7,0.4
Carl Landry ,207,31,9,2007,2015,8,2.8
Carl Landry ,207,31,9,2007,2016,9,2.1
Carl Nicks ,208,23,3,1980,1981,1,-0.2
Carl Nicks ,208,23,3,1980,1982,2,-0.3
Carl Nicks ,208,23,3,1980,1983,3,0.1
Carlos Boozer ,209,34,13,2002,2003,1,5.9
Carlos Boozer ,209,34,13,2002,2004,2,9.4
Carlos Boozer ,209,34,13,2002,2005,3,4.1
Carlos Boozer ,209,34,13,2002,2006,4,3.5
Carlos Boozer ,209,34,13,2002,2007,5,9.9
Carlos Boozer ,209,34,13,2002,2008,6,10.2
Carlos Boozer ,209,34,13,2002,2009,7,2.6
Carlos Boozer ,209,34,13,2002,2010,8,9.9
Carlos Boozer ,209,34,13,2002,2011,9,5.8
Carlos Boozer ,209,34,13,2002,2012,10,7.6
Carlos Boozer ,209,34,13,2002,2013,11,5.7
Carlos Boozer ,209,34,13,2002,2014,12,3.4
Carlos Boozer ,209,34,13,2002,2015,13,2.2
Carlos Delfino ,210,25,8,2003,2005,2,0.5
Carlos Delfino ,210,25,8,2003,2006,3,1
Carlos Delfino ,210,25,8,2003,2007,4,2.9
Carlos Delfino ,210,25,8,2003,2008,5,4
Carlos Delfino ,210,25,8,2003,2010,7,4.8
Carlos Delfino ,210,25,8,2003,2011,8,3.5
Carlos Delfino ,210,25,8,2003,2012,9,2.4
Carlos Delfino ,210,25,8,2003,2013,10,3.5
Carlos Rogers ,211,11,8,1994,1995,1,0.9
Carlos Rogers ,211,11,8,1994,1996,2,0.9
Carlos Rogers ,211,11,8,1994,1997,3,4
Carlos Rogers ,211,11,8,1994,1998,4,0.5
Carlos Rogers ,211,11,8,1994,1999,5,0
Carlos Rogers ,211,11,8,1994,2000,6,2.2
Carlos Rogers ,211,11,8,1994,2001,7,2
Carlos Rogers ,211,11,8,1994,2002,8,0.5
Carmelo Anthony ,212,3,13,2003,2004,1,6.1
Carmelo Anthony ,212,3,13,2003,2005,2,4.9
Carmelo Anthony ,212,3,13,2003,2006,3,9.4
Carmelo Anthony ,212,3,13,2003,2007,4,7.3
Carmelo Anthony ,212,3,13,2003,2008,5,8.2
Carmelo Anthony ,212,3,13,2003,2009,6,5
Carmelo Anthony ,212,3,13,2003,2010,7,7.9
Carmelo Anthony ,212,3,13,2003,2011,8,7.9
Carmelo Anthony ,212,3,13,2003,2012,9,6.2
Carmelo Anthony ,212,3,13,2003,2013,10,9.5
Carmelo Anthony ,212,3,13,2003,2014,11,10.7
Carmelo Anthony ,212,3,13,2003,2015,12,2.9
Carmelo Anthony ,212,3,13,2003,2016,13,6.4
Caron Butler ,213,10,14,2002,2003,1,5.1
Caron Butler ,213,10,14,2002,2004,2,2.1
Caron Butler ,213,10,14,2002,2005,3,5.3
Caron Butler ,213,10,14,2002,2006,4,6.3
Caron Butler ,213,10,14,2002,2007,5,5.3
Caron Butler ,213,10,14,2002,2008,6,7.2
Caron Butler ,213,10,14,2002,2009,7,4.5
Caron Butler ,213,10,14,2002,2010,8,3.5
Caron Butler ,213,10,14,2002,2011,9,1.2
Caron Butler ,213,10,14,2002,2012,10,2.3
Caron Butler ,213,10,14,2002,2013,11,3.6
Caron Butler ,213,10,14,2002,2014,12,1.8
Caron Butler ,213,10,14,2002,2015,13,2.4
Caron Butler ,213,10,14,2002,2016,14,0.3
Carrick Felix ,214,33,1,2013,2014,1,0
Casey Jacobsen ,215,22,4,2002,2003,1,1.2
Casey Jacobsen ,215,22,4,2002,2004,2,2.6
Casey Jacobsen ,215,22,4,2002,2005,3,2.7
Casey Jacobsen ,215,22,4,2002,2008,6,-0.3
Casey Shaw ,216,37,1,1998,1999,1,-0.1
Cedric Ceballos ,217,48,11,1990,1991,1,1.3
Cedric Ceballos ,217,48,11,1990,1992,2,1.3
Cedric Ceballos ,217,48,11,1990,1993,3,6.2
Cedric Ceballos ,217,48,11,1990,1994,4,5.5
Cedric Ceballos ,217,48,11,1990,1995,5,5.2
Cedric Ceballos ,217,48,11,1990,1996,6,9.8
Cedric Ceballos ,217,48,11,1990,1997,7,2.4
Cedric Ceballos ,217,48,11,1990,1998,8,2.8
Cedric Ceballos ,217,48,11,1990,1999,9,0.4
Cedric Ceballos ,217,48,11,1990,2000,10,4
Cedric Ceballos ,217,48,11,1990,2001,11,1.3
Cedric Henderson ,218,44,5,1997,1998,1,3.8
Cedric Henderson ,218,44,5,1997,1999,2,0.5
Cedric Henderson ,218,44,5,1997,2000,3,-0.2
Cedric Henderson ,218,44,5,1997,2001,4,-0.7
Cedric Henderson ,218,44,5,1997,2002,5,0
Cedric Henderson Jr.,219,32,1,1986,1987,1,0
Cedric Simmons ,220,15,3,2006,2007,1,0.3
Cedric Simmons ,220,15,3,2006,2008,2,-0.2
Cedric Simmons ,220,15,3,2006,2009,3,0
Cedrick Hordges ,221,49,2,1979,1981,2,1.5
Cedrick Hordges ,221,49,2,1979,1982,3,0.7
Chad Gallagher ,222,32,1,1991,1994,3,0.1
Chad Kinch ,223,22,1,1980,1981,1,-0.5
Chandler Parsons ,224,38,5,2011,2012,1,3.4
Chandler Parsons ,224,38,5,2011,2013,2,7
Chandler Parsons ,224,38,5,2011,2014,3,7.6
Chandler Parsons ,224,38,5,2011,2015,4,5.5
Chandler Parsons ,224,38,5,2011,2016,5,4.3
Channing Frye ,225,8,10,2005,2006,1,3.5
Channing Frye ,225,8,10,2005,2007,2,0.9
Channing Frye ,225,8,10,2005,2008,3,3.2
Channing Frye ,225,8,10,2005,2009,4,0.8
Channing Frye ,225,8,10,2005,2010,5,6.4
Channing Frye ,225,8,10,2005,2011,6,4.7
Channing Frye ,225,8,10,2005,2012,7,3.7
Channing Frye ,225,8,10,2005,2014,9,5.3
Channing Frye ,225,8,10,2005,2015,10,2.1
Channing Frye ,225,8,10,2005,2016,11,3
Charles Bradley ,226,23,3,1981,1982,1,0.2
Charles Bradley ,226,23,3,1981,1983,2,0.2
Charles Bradley ,226,23,3,1981,1984,3,-0.1
Charles Claxton ,227,50,1,1994,1996,2,0
Charles Davis ,228,35,8,1981,1982,1,0.9
Charles Davis ,228,35,8,1981,1983,2,1.5
Charles Davis ,228,35,8,1981,1984,3,0.3
Charles Davis ,228,35,8,1981,1985,4,1
Charles Davis ,228,35,8,1981,1986,5,2.1
Charles Davis ,228,35,8,1981,1988,7,-0.3
Charles Davis ,228,35,8,1981,1989,8,0.5
Charles Davis ,228,35,8,1981,1990,9,-0.2
Charles Jenkins ,229,44,2,2011,2012,1,0.5
Charles Jenkins ,229,44,2,2011,2013,2,0
Charles Jones ,230,36,4,1984,1985,1,2.9
Charles Jones ,230,36,4,1984,1986,2,0.6
Charles Jones ,230,36,4,1984,1988,4,0.8
Charles O'Bannon ,231,31,2,1997,1998,1,0.2
Charles O'Bannon ,231,31,2,1997,1999,2,0.3
Charles Oakley ,232,9,19,1985,1986,1,3.3
Charles Oakley ,232,9,19,1985,1987,2,3.5
Charles Oakley ,232,9,19,1985,1988,3,6.7
Charles Oakley ,232,9,19,1985,1989,4,5.7
Charles Oakley ,232,9,19,1985,1990,5,6
Charles Oakley ,232,9,19,1985,1991,6,6.2
Charles Oakley ,232,9,19,1985,1992,7,5.7
Charles Oakley ,232,9,19,1985,1993,8,7.3
Charles Oakley ,232,9,19,1985,1994,9,10.5
Charles Oakley ,232,9,19,1985,1995,10,4.5
Charles Oakley ,232,9,19,1985,1996,11,5.6
Charles Oakley ,232,9,19,1985,1997,12,8.9
Charles Oakley ,232,9,19,1985,1998,13,7
Charles Oakley ,232,9,19,1985,1999,14,2.1
Charles Oakley ,232,9,19,1985,2000,15,2.2
Charles Oakley ,232,9,19,1985,2001,16,3.7
Charles Oakley ,232,9,19,1985,2002,17,-0.5
Charles Oakley ,232,9,19,1985,2003,18,0.9
Charles Oakley ,232,9,19,1985,2004,19,0.1
Charles Shackleford ,233,32,6,1988,1989,1,0.8
Charles Shackleford ,233,32,6,1988,1990,2,1.5
Charles Shackleford ,233,32,6,1988,1992,4,2.7
Charles Shackleford ,233,32,6,1988,1993,5,0.9
Charles Shackleford ,233,32,6,1988,1995,7,0.8
Charles Shackleford ,233,32,6,1988,1999,11,0.7
Charles Smith ,234,3,5,1988,1989,1,4
Charles Smith ,234,3,5,1988,1990,2,9.4
Charles Smith ,234,3,5,1988,1991,3,7.4
Charles Smith ,234,3,5,1997,1992,4,4.4
Charles Smith ,234,3,5,1988,1993,5,6.6
Charles Smith ,234,3,5,1988,1994,6,2.4
Charles Smith ,234,3,5,1988,1995,7,4.8
Charles Smith ,234,3,5,1988,1996,8,1.9
Charles Smith ,234,3,5,1988,1997,9,0
Charles SmithY,235,23,5,1997,1998,1,-0.3
Charles SmithY,235,23,5,1997,1999,2,-0.5
Charles SmithY,235,23,5,1997,2000,3,2
Charles SmithY,235,23,5,1997,2001,4,0
Charles SmithY,235,23,5,1997,2002,5,0.3
Charlie Sitton ,236,38,1,1984,1985,1,0.1
Charlie Villanueva ,237,7,11,2005,2006,1,3.9
Charlie Villanueva ,237,7,11,2005,2007,2,1.7
Charlie Villanueva ,237,7,11,2005,2008,3,1.7
Charlie Villanueva ,237,7,11,2005,2009,4,4.9
Charlie Villanueva ,237,7,11,2005,2010,5,3.5
Charlie Villanueva ,237,7,11,2005,2011,6,3.1
Charlie Villanueva ,237,7,11,2005,2012,7,0.4
Charlie Villanueva ,237,7,11,2005,2013,8,1.6
Charlie Villanueva ,237,7,11,2005,2014,9,0.1
Charlie Villanueva ,237,7,11,2005,2015,10,1.4
Charlie Villanueva ,237,7,11,2005,2016,11,0.2
Charlie Ward ,238,26,11,1994,1995,1,-0.2
Charlie Ward ,238,26,11,1994,1996,2,1
Charlie Ward ,238,26,11,1994,1997,3,3.6
Charlie Ward ,238,26,11,1994,1998,4,7.1
Charlie Ward ,238,26,11,1994,1999,5,3.1
Charlie Ward ,238,26,11,1994,2000,6,5.5
Charlie Ward ,238,26,11,1994,2001,7,3.9
Charlie Ward ,238,26,11,1994,2002,8,1.9
Charlie Ward ,238,26,11,1994,2003,9,3.7
Charlie Ward ,238,26,11,1994,2004,10,2.9
Charlie Ward ,238,26,11,1994,2005,11,0.5
Chase Budinger ,239,44,7,2009,2010,1,3.1
Chase Budinger ,239,44,7,2009,2011,2,3.4
Chase Budinger ,239,44,7,2009,2012,3,3
Chase Budinger ,239,44,7,2009,2013,4,0.7
Chase Budinger ,239,44,7,2009,2014,5,0.9
Chase Budinger ,239,44,7,2009,2015,6,1.3
Chase Budinger ,239,44,7,2009,2016,7,1.4
Chauncey Billups ,240,3,17,1997,1998,1,3
Chauncey Billups ,240,3,17,1997,1999,2,2.3
Chauncey Billups ,240,3,17,1997,2000,3,0.1
Chauncey Billups ,240,3,17,1997,2001,4,3.7
Chauncey Billups ,240,3,17,1997,2002,5,7.6
Chauncey Billups ,240,3,17,1997,2003,6,9.9
Chauncey Billups ,240,3,17,1997,2004,7,11.3
Chauncey Billups ,240,3,17,1997,2005,8,12.1
Chauncey Billups ,240,3,17,1997,2006,9,15.5
Chauncey Billups ,240,3,17,1997,2007,10,11.4
Chauncey Billups ,240,3,17,1997,2008,11,13.5
Chauncey Billups ,240,3,17,1997,2009,12,10.1
Chauncey Billups ,240,3,17,1997,2010,13,9.5
Chauncey Billups ,240,3,17,1997,2011,14,8
Chauncey Billups ,240,3,17,1997,2012,15,1.7
Chauncey Billups ,240,3,17,1997,2013,16,1.3
Chauncey Billups ,240,3,17,1997,2014,17,-0.3
Cherokee Parks ,241,12,9,1995,1996,1,0.9
Cherokee Parks ,241,12,9,1995,1997,2,2.2
Cherokee Parks ,241,12,9,1995,1998,3,3.8
Cherokee Parks ,241,12,9,1995,1999,4,0.2
Cherokee Parks ,241,12,9,1995,2000,5,1.4
Cherokee Parks ,241,12,9,1995,2001,6,1.9
Cherokee Parks ,241,12,9,1995,2002,7,0
Cherokee Parks ,241,12,9,1995,2003,8,1.2
Cherokee Parks ,241,12,9,1995,2004,9,0.1
Chris Anstey ,242,18,3,1997,1998,1,0.6
Chris Anstey ,242,18,3,1997,1999,2,0.3
Chris Anstey ,242,18,3,1997,2000,3,1.9
Chris Bosh ,243,4,13,2003,2004,1,6.2
Chris Bosh ,243,4,13,2003,2005,2,6.8
Chris Bosh ,243,4,13,2003,2006,3,9.8
Chris Bosh ,243,4,13,2003,2007,4,9.6
Chris Bosh ,243,4,13,2003,2008,5,10.1
Chris Bosh ,243,4,13,2003,2009,6,9.7
Chris Bosh ,243,4,13,2003,2010,7,9.6
Chris Bosh ,243,4,13,2003,2011,8,10.3
Chris Bosh ,243,4,13,2003,2012,9,6.9
Chris Bosh ,243,4,13,2003,2013,10,9
Chris Bosh ,243,4,13,2003,2014,11,8
Chris Bosh ,243,4,13,2003,2015,12,3.6
Chris Bosh ,243,4,13,2003,2016,13,6.4
Chris Corchiani ,244,36,3,1991,1992,1,0.9
Chris Corchiani ,244,36,3,1991,1993,2,0.3
Chris Corchiani ,244,36,3,1991,1994,3,0.4
Chris Crawford ,245,50,7,1997,1998,1,0.9
Chris Crawford ,245,50,7,1997,1999,2,1.3
Chris Crawford ,245,50,7,1997,2000,3,0.6
Chris Crawford ,245,50,7,1997,2001,4,0.6
Chris Crawford ,245,50,7,1997,2002,5,0.1
Chris Crawford ,245,50,7,1997,2003,6,0.2
Chris Crawford ,245,50,7,1997,2004,7,2.7
Chris Douglas-Roberts ,246,40,6,2008,2009,1,0.6
Chris Douglas-Roberts ,246,40,6,2008,2010,2,0.7
Chris Douglas-Roberts ,246,40,6,2008,2011,3,1.6
Chris Douglas-Roberts ,246,40,6,2008,2013,5,0.1
Chris Douglas-Roberts ,246,40,6,2008,2014,6,2.4
Chris Douglas-Roberts ,246,40,6,2008,2015,7,0
Chris Duhon ,247,38,9,2004,2005,1,4.1
Chris Duhon ,247,38,9,2004,2006,2,5.2
Chris Duhon ,247,38,9,2004,2007,3,4.8
Chris Duhon ,247,38,9,2004,2008,4,2.3
Chris Duhon ,247,38,9,2004,2009,5,4.2
Chris Duhon ,247,38,9,2004,2010,6,1.9
Chris Duhon ,247,38,9,2004,2011,7,0.2
Chris Duhon ,247,38,9,2004,2012,8,1.3
Chris Duhon ,247,38,9,2004,2013,9,1
Chris Gatling ,248,16,11,1991,1992,1,2
Chris Gatling ,248,16,11,1991,1993,2,3.1
Chris Gatling ,248,16,11,1991,1994,3,4.5
Chris Gatling ,248,16,11,1991,1995,4,3.9
Chris Gatling ,248,16,11,1991,1996,5,4.6
Chris Gatling ,248,16,11,1991,1997,6,3.9
Chris Gatling ,248,16,11,1991,1998,7,2.4
Chris Gatling ,248,16,11,1991,1999,8,-0.1
Chris Gatling ,248,16,11,1991,2000,9,4
Chris Gatling ,248,16,11,1991,2001,10,2.4
Chris Gatling ,248,16,11,1991,2002,11,1.4
Chris Herren ,249,33,2,1999,2000,1,0.5
Chris Herren ,249,33,2,1999,2001,2,0
Chris Jefferies ,250,27,2,2002,2003,1,-0.5
Chris Jefferies ,250,27,2,2002,2004,2,0
Chris Kaman ,251,6,13,2003,2004,1,0
Chris Kaman ,251,6,13,2003,2005,2,2.1
Chris Kaman ,251,6,13,2003,2006,3,6.1
Chris Kaman ,251,6,13,2003,2007,4,2.9
Chris Kaman ,251,6,13,2003,2008,5,3.6
Chris Kaman ,251,6,13,2003,2009,6,0.6
Chris Kaman ,251,6,13,2003,2010,7,2.4
Chris Kaman ,251,6,13,2003,2011,8,0.8
Chris Kaman ,251,6,13,2003,2012,9,0.7
Chris Kaman ,251,6,13,2003,2013,10,1.6
Chris Kaman ,251,6,13,2003,2014,11,0.5
Chris Kaman ,251,6,13,2003,2015,12,3.3
Chris Kaman ,251,6,13,2003,2016,13,0.1
Chris King ,252,45,3,1992,1994,2,0
Chris King ,252,45,3,1992,1996,4,1.1
Chris King ,252,45,3,1992,1999,7,-0.1
Chris McCullough ,253,29,1,2015,2016,1,0.3
Chris McNealy ,254,38,3,1983,1986,3,1.6
Chris McNealy ,254,38,3,1983,1987,4,0.8
Chris McNealy ,254,38,3,1983,1988,5,0.2
Chris Mihm ,255,7,8,2000,2001,1,1.3
Chris Mihm ,255,7,8,2000,2002,2,0.7
Chris Mihm ,255,7,8,2000,2003,3,0.9
Chris Mihm ,255,7,8,2000,2004,4,2.9
Chris Mihm ,255,7,8,2000,2005,5,3.6
Chris Mihm ,255,7,8,2000,2006,6,4
Chris Mihm ,255,7,8,2000,2008,8,0
Chris Mihm ,255,7,8,2000,2009,9,0.1
Chris Mills ,256,22,10,1993,1994,1,4
Chris Mills ,256,22,10,1993,1995,2,5.4
Chris Mills ,256,22,10,1993,1996,3,7.8
Chris Mills ,256,22,10,1993,1997,4,8.9
Chris Mills ,256,22,10,1993,1998,5,5.1
Chris Mills ,256,22,10,1993,1999,6,3
Chris Mills ,256,22,10,1993,2000,7,1.2
Chris Mills ,256,22,10,1993,2001,8,0.1
Chris Mills ,256,22,10,1993,2002,9,1.9
Chris Mills ,256,22,10,1993,2003,10,0.3
Chris Morris ,257,4,11,1988,1989,1,2.8
Chris Morris ,257,4,11,1988,1990,2,3.2
Chris Morris ,257,4,11,1988,1991,3,4.5
Chris Morris ,257,4,11,1988,1992,4,4.7
Chris Morris ,257,4,11,1988,1993,5,7.2
Chris Morris ,257,4,11,1988,1994,6,3.8
Chris Morris ,257,4,11,1988,1995,7,4
Chris Morris ,257,4,11,1988,1996,8,3.3
Chris Morris ,257,4,11,1988,1997,9,1.2
Chris Morris ,257,4,11,1988,1998,10,1
Chris Morris ,257,4,11,1988,1999,11,1.6
Chris Owens ,258,47,1,2002,2003,1,0
Chris Paul ,259,4,11,2005,2006,1,10.4
Chris Paul ,259,4,11,2005,2007,2,8.8
Chris Paul ,259,4,11,2005,2008,3,17.8
Chris Paul ,259,4,11,2005,2009,4,18.3
Chris Paul ,259,4,11,2005,2010,5,7.3
Chris Paul ,259,4,11,2005,2011,6,13.9
Chris Paul ,259,4,11,2005,2012,7,12.7
Chris Paul ,259,4,11,2005,2013,8,13.9
Chris Paul ,259,4,11,2005,2014,9,12.2
Chris Paul ,259,4,11,2005,2015,10,16.1
Chris Paul ,259,4,11,2005,2016,11,12.7
Chris Richard ,260,41,2,2007,2008,1,0.4
Chris Richard ,260,41,2,2007,2010,3,0.3
Chris Singleton ,261,18,3,2011,2012,1,1.5
Chris Singleton ,261,18,3,2011,2013,2,0.5
Chris Singleton ,261,18,3,2011,2014,3,0.2
Chris Smith ,262,34,3,1992,1993,1,1.1
Chris Smith ,262,34,3,1992,1994,2,0.9
Chris Smith ,262,34,3,1992,1995,3,1.2
Chris Smith ,262,34,3,1992,2014,22,0
Chris Taft ,263,42,1,2005,2006,1,0.5
Chris Washburn ,264,3,2,1986,1987,1,-0.8
Chris Washburn ,264,3,2,1986,1988,2,0.2
Chris Webber ,265,1,15,1993,1994,1,7.8
Chris Webber ,265,1,15,1993,1995,2,4
Chris Webber ,265,1,15,1993,1996,3,1.9
Chris Webber ,265,1,15,1993,1997,4,9.3
Chris Webber ,265,1,15,1993,1998,5,8.3
Chris Webber ,265,1,15,1993,1999,6,3.6
Chris Webber ,265,1,15,1993,2000,7,10.7
Chris Webber ,265,1,15,1993,2001,8,11
Chris Webber ,265,1,15,1993,2002,9,8.6
Chris Webber ,265,1,15,1993,2003,10,6.9
Chris Webber ,265,1,15,1993,2004,11,1.1
Chris Webber ,265,1,15,1993,2005,12,3.4
Chris Webber ,265,1,15,1993,2006,13,4.4
Chris Webber ,265,1,15,1993,2007,14,3.4
Chris Webber ,265,1,15,1993,2008,15,0.1
Chris Welp ,266,16,3,1987,1988,1,0.3
Chris Welp ,266,16,3,1987,1989,2,0.7
Chris Welp ,266,16,3,1987,1990,3,0
Chris Whitney ,267,47,11,1993,1994,1,-0.3
Chris Whitney ,267,47,11,1993,1995,2,-0.2
Chris Whitney ,267,47,11,1993,1996,3,1.3
Chris Whitney ,267,47,11,1993,1997,4,3.2
Chris Whitney ,267,47,11,1993,1998,5,2.7
Chris Whitney ,267,47,11,1993,1999,6,1
Chris Whitney ,267,47,11,1993,2000,7,4
Chris Whitney ,267,47,11,1993,2001,8,2.3
Chris Whitney ,267,47,11,1993,2002,9,6.5
Chris Whitney ,267,47,11,1993,2003,10,0.6
Chris Whitney ,267,47,11,1993,2004,11,0.2
Chris Wilcox ,268,8,11,2002,2003,1,0.6
Chris Wilcox ,268,8,11,2002,2004,2,2.6
Chris Wilcox ,268,8,11,2002,2005,3,1.3
Chris Wilcox ,268,8,11,2002,2006,4,4.4
Chris Wilcox ,268,8,11,2002,2007,5,6
Chris Wilcox ,268,8,11,2002,2008,6,3.4
Chris Wilcox ,268,8,11,2002,2009,7,1.1
Chris Wilcox ,268,8,11,2002,2010,8,0.2
Chris Wilcox ,268,8,11,2002,2011,9,2.8
Chris Wilcox ,268,8,11,2002,2012,10,1.3
Chris Wilcox ,268,8,11,2002,2013,11,3.1
Christian Eyenga ,269,30,2,2009,2011,2,-0.3
Christian Eyenga ,269,30,2,2009,2012,3,-0.1
Christian Laettner ,270,3,13,1992,1993,1,5
Christian Laettner ,270,3,13,1992,1994,2,4.1
Christian Laettner ,270,3,13,1992,1995,3,6.2
Christian Laettner ,270,3,13,1992,1996,4,6.2
Christian Laettner ,270,3,13,1992,1997,5,11.6
Christian Laettner ,270,3,13,1992,1998,6,7.5
Christian Laettner ,270,3,13,1992,1999,7,0.7
Christian Laettner ,270,3,13,1992,2000,8,5.1
Christian Laettner ,270,3,13,1992,2001,9,4.3
Christian Laettner ,270,3,13,1992,2002,10,2.6
Christian Laettner ,270,3,13,1992,2003,11,6.6
Christian Laettner ,270,3,13,1992,2004,12,2.3
Christian Laettner ,270,3,13,1992,2005,13,2.7
Chuck Person ,271,4,13,1986,1987,1,5.4
Chuck Person ,271,4,13,1986,1988,2,3.3
Chuck Person ,271,4,13,1986,1989,3,3
Chuck Person ,271,4,13,1986,1990,4,5.4
Chuck Person ,271,4,13,1986,1991,5,3.9
Chuck Person ,271,4,13,1986,1992,6,4.6
Chuck Person ,271,4,13,1986,1993,7,0
Chuck Person ,271,4,13,1986,1994,8,1.2
Chuck Person ,271,4,13,1986,1995,9,3.6
Chuck Person ,271,4,13,1986,1996,10,5.5
Chuck Person ,271,4,13,1986,1998,12,2.1
Chuck Person ,271,4,13,1986,1999,13,0.9
Chuck Person ,271,4,13,1986,2000,14,-0.1
Chucky Brown ,272,43,13,1989,1990,1,2.2
Chucky Brown ,272,43,13,1989,1991,2,1.6
Chucky Brown ,272,43,13,1989,1992,3,0.3
Chucky Brown ,272,43,13,1989,1993,4,2.2
Chucky Brown ,272,43,13,1989,1994,5,0
Chucky Brown ,272,43,13,1989,1995,6,2.1
Chucky Brown ,272,43,13,1989,1996,7,4.2
Chucky Brown ,272,43,13,1989,1997,8,1.6
Chucky Brown ,272,43,13,1989,1998,9,1.4
Chucky Brown ,272,43,13,1989,1999,10,1.6
Chucky Brown ,272,43,13,1989,2000,11,1.3
Chucky Brown ,272,43,13,1989,2001,12,0.4
Chucky Brown ,272,43,13,1989,2002,13,0.1
Clarence Weatherspoon ,273,9,13,1992,1993,1,3.3
Clarence Weatherspoon ,273,9,13,1992,1994,2,6
Clarence Weatherspoon ,273,9,13,1992,1995,3,3.6
Clarence Weatherspoon ,273,9,13,1992,1996,4,5.8
Clarence Weatherspoon ,273,9,13,1992,1997,5,5
Clarence Weatherspoon ,273,9,13,1992,1998,6,4.5
Clarence Weatherspoon ,273,9,13,1992,1999,7,4
Clarence Weatherspoon ,273,9,13,1992,2000,8,5.1
Clarence Weatherspoon ,273,9,13,1992,2001,9,8.6
Clarence Weatherspoon ,273,9,13,1992,2002,10,3.5
Clarence Weatherspoon ,273,9,13,1992,2003,11,5.5
Clarence Weatherspoon ,273,9,13,1992,2004,12,2.6
Clarence Weatherspoon ,273,9,13,1992,2005,13,1.1
Clark Kellogg ,274,8,5,1982,1983,1,6.8
Clark Kellogg ,274,8,5,1982,1984,2,7
Clark Kellogg ,274,8,5,1982,1985,3,6.1
Clark Kellogg ,274,8,5,1982,1986,4,0.9
Clark Kellogg ,274,8,5,1982,1987,5,0.1
Claude Gregory ,275,41,2,1981,1986,5,0
Claude Gregory ,275,41,2,1981,1988,7,0.1
Cleanthony Early ,276,34,2,2014,2015,1,-0.4
Cleanthony Early ,276,34,2,2014,2016,2,-0.2
Clemon Johnson ,277,44,10,1978,1979,1,1.2
Clemon Johnson ,277,44,10,1978,1980,2,3.5
Clemon Johnson ,277,44,10,1978,1981,3,3.7
Clemon Johnson ,277,44,10,1978,1982,4,4
Clemon Johnson ,277,44,10,1978,1983,5,4.3
Clemon Johnson ,277,44,10,1978,1984,6,2.2
Clemon Johnson ,277,44,10,1978,1985,7,1.7
Clemon Johnson ,277,44,10,1978,1986,8,2
Clemon Johnson ,277,44,10,1978,1987,9,2
Clemon Johnson ,277,44,10,1978,1988,10,0.9
Cliff Levingston ,278,9,11,1982,1983,1,1.3
Cliff Levingston ,278,9,11,1982,1984,2,5.3
Cliff Levingston ,278,9,11,1982,1985,3,4.7
Cliff Levingston ,278,9,11,1982,1986,4,5.5
Cliff Levingston ,278,9,11,1982,1987,5,6.1
Cliff Levingston ,278,9,11,1982,1988,6,7
Cliff Levingston ,278,9,11,1982,1989,7,5.5
Cliff Levingston ,278,9,11,1982,1990,8,3.4
Cliff Levingston ,278,9,11,1982,1991,9,2
Cliff Levingston ,278,9,11,1982,1992,10,2.9
Cliff Levingston ,278,9,11,1982,1995,13,0.5
Cliff Robinson ,279,11,11,1979,1980,1,3.6
Cliff Robinson ,279,11,11,1979,1981,2,2.5
Cliff Robinson ,279,11,11,1979,1982,3,3.5
Cliff Robinson ,279,11,11,1979,1983,4,4.4
Cliff Robinson ,279,11,11,1979,1984,5,3.1
Cliff Robinson ,279,11,11,1979,1985,6,2.9
Cliff Robinson ,279,11,11,1979,1986,7,5.6
Cliff Robinson ,279,11,11,1979,1987,8,2.1
Cliff Robinson ,279,11,11,1979,1988,9,2.6
Cliff Robinson ,279,11,11,1979,1989,10,0.3
Cliff Robinson ,279,11,11,1979,1992,13,0.1
Clifford Robinson ,280,36,18,1989,1990,1,0.3
Clifford Robinson ,280,36,18,1989,1991,2,4.2
Clifford Robinson ,280,36,18,1989,1992,3,4.6
Clifford Robinson ,280,36,18,1989,1993,4,6.8
Clifford Robinson ,280,36,18,1989,1994,5,7.5
Clifford Robinson ,280,36,18,1989,1995,6,8.7
Clifford Robinson ,280,36,18,1989,1996,7,8
Clifford Robinson ,280,36,18,1989,1997,8,6.6
Clifford Robinson ,280,36,18,1989,1998,9,7.1
Clifford Robinson ,280,36,18,1989,1999,10,5.3
Clifford Robinson ,280,36,18,1989,2000,11,9.6
Clifford Robinson ,280,36,18,1989,2001,12,5.4
Clifford Robinson ,280,36,18,1989,2002,13,4.3
Clifford Robinson ,280,36,18,1989,2003,14,4.4
Clifford Robinson ,280,36,18,1989,2004,15,2
Clifford Robinson ,280,36,18,1989,2005,16,1.7
Clifford Robinson ,280,36,18,1989,2006,17,2.8
Clifford Robinson ,280,36,18,1989,2007,18,0.3
Clifford Rozier ,281,16,4,1994,1995,1,1.3
Clifford Rozier ,281,16,4,1994,1996,2,1.1
Clifford Rozier ,281,16,4,1994,1997,3,1.6
Clifford Rozier ,281,16,4,1994,1998,4,-0.1
Clint Capela ,282,25,2,2014,2015,1,0
Clint Capela ,282,25,2,2014,2016,2,4.4
Clint Richardson ,283,36,8,1979,1980,1,1.1
Clint Richardson ,283,36,8,1979,1981,2,2.4
Clint Richardson ,283,36,8,1979,1982,3,1
Clint Richardson ,283,36,8,1979,1983,4,3.3
Clint Richardson ,283,36,8,1979,1984,5,1.9
Clint Richardson ,283,36,8,1979,1985,6,1.8
Clint Richardson ,283,36,8,1979,1986,7,3.1
Clint Richardson ,283,36,8,1979,1987,8,2.1
Cody Zeller ,284,4,3,2013,2014,1,2.6
Cody Zeller ,284,4,3,2013,2015,2,3.8
Cody Zeller ,284,4,3,2013,2016,3,6.3
Cole Aldrich ,285,11,6,2010,2011,1,0.2
Cole Aldrich ,285,11,6,2010,2012,2,0.6
Cole Aldrich ,285,11,6,2010,2013,3,0.6
Cole Aldrich ,285,11,6,2010,2014,4,1.2
Cole Aldrich ,285,11,6,2010,2015,5,2.2
Cole Aldrich ,285,11,6,2010,2016,6,3.5
Corey Benjamin ,286,28,4,1998,1999,1,-0.2
Corey Benjamin ,286,28,4,1998,2000,2,-0.2
Corey Benjamin ,286,28,4,1998,2001,3,-0.5
Corey Benjamin ,286,28,4,1998,2003,5,0
Corey Brewer ,287,7,9,2007,2008,1,-0.2
Corey Brewer ,287,7,9,2007,2009,2,0.3
Corey Brewer ,287,7,9,2007,2010,3,1
Corey Brewer ,287,7,9,2007,2011,4,1.1
Corey Brewer ,287,7,9,2007,2012,5,2.3
Corey Brewer ,287,7,9,2007,2013,6,3.9
Corey Brewer ,287,7,9,2007,2014,7,5.2
Corey Brewer ,287,7,9,2007,2015,8,3.1
Corey Brewer ,287,7,9,2007,2016,9,1.2
Corey Maggette ,288,13,14,1999,2000,1,2.6
Corey Maggette ,288,13,14,1999,2001,2,3.9
Corey Maggette ,288,13,14,1999,2002,3,3.3
Corey Maggette ,288,13,14,1999,2003,4,5
Corey Maggette ,288,13,14,1999,2004,5,8.6
Corey Maggette ,288,13,14,1999,2005,6,8.1
Corey Maggette ,288,13,14,1999,2006,7,3
Corey Maggette ,288,13,14,1999,2007,8,7
Corey Maggette ,288,13,14,1999,2008,9,6.9
Corey Maggette ,288,13,14,1999,2009,10,3.3
Corey Maggette ,288,13,14,1999,2010,11,6.3
Corey Maggette ,288,13,14,1999,2011,12,3.4
Corey Maggette ,288,13,14,1999,2012,13,0.7
Corey Maggette ,288,13,14,1999,2013,14,0.1
Corey Williams ,289,33,2,1992,1993,1,0.2
Corey Williams ,289,33,2,1992,1994,2,0
Corie Blount ,290,25,11,1993,1994,1,1.2
Corie Blount ,290,25,11,1993,1995,2,1.7
Corie Blount ,290,25,11,1993,1996,3,0.9
Corie Blount ,290,25,11,1993,1997,4,2.5
Corie Blount ,290,25,11,1993,1998,5,2.6
Corie Blount ,290,25,11,1993,1999,6,0.7
Corie Blount ,290,25,11,1993,2000,7,0.8
Corie Blount ,290,25,11,1993,2001,8,1.8
Corie Blount ,290,25,11,1993,2002,9,3.1
Corie Blount ,290,25,11,1993,2003,10,1.1
Corie Blount ,290,25,11,1993,2004,11,1.9
Corliss Williamson ,291,13,12,1995,1996,1,-0.8
Corliss Williamson ,291,13,12,1995,1997,2,2.7
Corliss Williamson ,291,13,12,1995,1998,3,4.4
Corliss Williamson ,291,13,12,1995,1999,4,2.5
Corliss Williamson ,291,13,12,1995,2000,5,3.6
Corliss Williamson ,291,13,12,1995,2001,6,3.2
Corliss Williamson ,291,13,12,1995,2002,7,5.1
Corliss Williamson ,291,13,12,1995,2003,8,4.9
Corliss Williamson ,291,13,12,1995,2004,9,4.1
Corliss Williamson ,291,13,12,1995,2005,10,3.3
Corliss Williamson ,291,13,12,1995,2006,11,0.2
Corliss Williamson ,291,13,12,1995,2007,12,1.5
Corny Thompson ,292,50,1,1982,1983,1,-0.1
Cory Alexander ,293,29,7,1995,1996,1,0.2
Cory Alexander ,293,29,7,1995,1997,2,1.1
Cory Alexander ,293,29,7,1995,1998,3,2.2
Cory Alexander ,293,29,7,1995,1999,4,-0.3
Cory Alexander ,293,29,7,1995,2000,5,-0.1
Cory Alexander ,293,29,7,1995,2001,6,-0.1
Cory Alexander ,293,29,7,1995,2005,10,0
Cory Blackwell ,294,28,1,1984,1985,1,-0.9
Cory Carr ,295,49,1,1998,1999,1,-1.2
Cory Joseph ,296,29,5,2011,2012,1,0
Cory Joseph ,296,29,5,2011,2013,2,0.9
Cory Joseph ,296,29,5,2011,2014,3,2.9
Cory Joseph ,296,29,5,2011,2015,4,4.5
Cory Joseph ,296,29,5,2011,2016,5,3.5
Courtney Alexander ,297,13,3,2000,2001,1,0.8
Courtney Alexander ,297,13,3,2000,2002,2,2.2
Courtney Alexander ,297,13,3,2000,2003,3,1.1
Courtney Lee ,298,22,8,2008,2009,1,4.4
Courtney Lee ,298,22,8,2008,2010,2,3.1
Courtney Lee ,298,22,8,2008,2011,3,2.7
Courtney Lee ,298,22,8,2008,2012,4,3.2
Courtney Lee ,298,22,8,2008,2013,5,3.3
Courtney Lee ,298,22,8,2008,2014,6,4.7
Courtney Lee ,298,22,8,2008,2015,7,4.8
Courtney Lee ,298,22,8,2008,2016,8,3.9
Craig Brackins ,299,21,2,2010,2011,1,-0.1
Craig Brackins ,299,21,2,2010,2012,2,-0.1
Craig Ehlo ,300,48,14,1983,1984,1,0
Craig Ehlo ,300,48,14,1983,1985,2,0.2
Craig Ehlo ,300,48,14,1983,1986,3,0.5
Craig Ehlo ,300,48,14,1983,1987,4,1.2
Craig Ehlo ,300,48,14,1983,1988,5,3.1
Craig Ehlo ,300,48,14,1983,1989,6,4.6
Craig Ehlo ,300,48,14,1983,1990,7,6.5
Craig Ehlo ,300,48,14,1983,1991,8,3.4
Craig Ehlo ,300,48,14,1983,1992,9,3.8
Craig Ehlo ,300,48,14,1983,1993,10,6.2
Craig Ehlo ,300,48,14,1983,1994,11,5.9
Craig Ehlo ,300,48,14,1983,1995,12,2.1
Craig Ehlo ,300,48,14,1983,1996,13,3.3
Craig Ehlo ,300,48,14,1983,1997,14,0.3
Craig Hodges ,301,48,10,1982,1983,1,0.8
Craig Hodges ,301,48,10,1982,1984,2,0.5
Craig Hodges ,301,48,10,1982,1985,3,6
Craig Hodges ,301,48,10,1982,1986,4,5.3
Craig Hodges ,301,48,10,1982,1987,5,4.3
Craig Hodges ,301,48,10,1982,1988,6,2.4
Craig Hodges ,301,48,10,1982,1989,7,2.9
Craig Hodges ,301,48,10,1982,1990,8,2.6
Craig Hodges ,301,48,10,1982,1991,9,1.7
Craig Hodges ,301,48,10,1982,1992,10,0.8
Craig Shelton ,302,28,2,1980,1981,1,0
Craig Shelton ,302,28,2,1980,1982,2,0
Craig Smith ,303,36,6,2006,2007,1,3.9
Craig Smith ,303,36,6,2006,2008,2,3.5
Craig Smith ,303,36,6,2006,2009,3,3.1
Craig Smith ,303,36,6,2006,2010,4,3
Craig Smith ,303,36,6,2006,2011,5,1.5
Craig Smith ,303,36,6,2006,2012,6,1
Curtis Borchardt ,304,18,2,2002,2004,2,0.1
Curtis Borchardt ,304,18,2,2002,2005,3,0.8
Cuttino Mobley ,305,41,11,1998,1999,1,2.3
Cuttino Mobley ,305,41,11,1998,2000,2,5.2
Cuttino Mobley ,305,41,11,1998,2001,3,8.2
Cuttino Mobley ,305,41,11,1998,2002,4,5.7
Cuttino Mobley ,305,41,11,1998,2003,5,6.9
Cuttino Mobley ,305,41,11,1998,2004,6,7.6
Cuttino Mobley ,305,41,11,1998,2005,7,4.4
Cuttino Mobley ,305,41,11,1998,2006,8,5.3
Cuttino Mobley ,305,41,11,1998,2007,9,4.6
Cuttino Mobley ,305,41,11,1998,2008,10,2.1
Cuttino Mobley ,305,41,11,1998,2009,11,-0.1
D.J. Augustin ,306,9,8,2008,2009,1,5.1
D.J. Augustin ,306,9,8,2008,2010,2,2.8
D.J. Augustin ,306,9,8,2008,2011,3,6.2
D.J. Augustin ,306,9,8,2008,2012,4,0.5
D.J. Augustin ,306,9,8,2008,2013,5,2.8
D.J. Augustin ,306,9,8,2008,2014,6,6.2
D.J. Augustin ,306,9,8,2008,2015,7,3.4
D.J. Augustin ,306,9,8,2008,2016,8,2.6
D.J. White ,307,29,6,2008,2009,1,0.4
D.J. White ,307,29,6,2008,2010,2,0.6
D.J. White ,307,29,6,2008,2011,3,1.8
D.J. White ,307,29,6,2008,2012,4,0.8
D.J. White ,307,29,6,2008,2013,5,0.2
D.J. White ,307,29,6,2008,2014,6,0
D'Angelo Russell ,308,2,1,2015,2016,1,0
Daequan Cook ,309,21,6,2007,2008,1,-0.4
Daequan Cook ,309,21,6,2007,2009,2,2.2
Daequan Cook ,309,21,6,2007,2010,3,0.1
Daequan Cook ,309,21,6,2007,2011,4,1.6
Daequan Cook ,309,21,6,2007,2012,5,1.6
Daequan Cook ,309,21,6,2007,2013,6,-0.2
Dahntay Jones ,310,20,12,2003,2004,1,-0.4
Dahntay Jones ,310,20,12,2003,2005,2,0.9
Dahntay Jones ,310,20,12,2003,2006,3,0.6
Dahntay Jones ,310,20,12,2003,2007,4,0.7
Dahntay Jones ,310,20,12,2003,2008,5,0.4
Dahntay Jones ,310,20,12,2003,2009,6,2
Dahntay Jones ,310,20,12,2003,2010,7,1.8
Dahntay Jones ,310,20,12,2003,2011,8,1.2
Dahntay Jones ,310,20,12,2003,2012,9,2
Dahntay Jones ,310,20,12,2003,2013,10,0.6
Dahntay Jones ,310,20,12,2003,2015,12,0
Dahntay Jones ,310,20,12,2003,2016,13,0.1
DaJuan Summers ,311,35,4,2009,2010,1,0
DaJuan Summers ,311,35,4,2009,2011,2,-0.3
DaJuan Summers ,311,35,4,2009,2012,3,0.2
DaJuan Summers ,311,35,4,2009,2013,4,0
Dajuan Wagner ,312,6,4,2002,2003,1,0.3
Dajuan Wagner ,312,6,4,2002,2004,2,-0.1
Dajuan Wagner ,312,6,4,2002,2005,3,-0.2
Dajuan Wagner ,312,6,4,2002,2007,5,0
Dale Davis ,313,13,16,1991,1992,1,3.4
Dale Davis ,313,13,16,1991,1993,2,6.9
Dale Davis ,313,13,16,1991,1994,3,7
Dale Davis ,313,13,16,1991,1995,4,6.8
Dale Davis ,313,13,16,1991,1996,5,6.2
Dale Davis ,313,13,16,1991,1997,6,6.7
Dale Davis ,313,13,16,1991,1998,7,7.1
Dale Davis ,313,13,16,1991,1999,8,4.5
Dale Davis ,313,13,16,1991,2000,9,7.1
Dale Davis ,313,13,16,1991,2001,10,6.6
Dale Davis ,313,13,16,1991,2002,11,8.5
Dale Davis ,313,13,16,1991,2003,12,6.9
Dale Davis ,313,13,16,1991,2004,13,3.9
Dale Davis ,313,13,16,1991,2005,14,3.4
Dale Davis ,313,13,16,1991,2006,15,0.4
Dale Davis ,313,13,16,1991,2007,16,1.3
Dale Ellis ,314,9,17,1983,1984,1,1.5
Dale Ellis ,314,9,17,1983,1985,2,2.4
Dale Ellis ,314,9,17,1983,1986,3,1.6
Dale Ellis ,314,9,17,1983,1987,4,9.3
Dale Ellis ,314,9,17,1983,1988,5,9
Dale Ellis ,314,9,17,1983,1989,6,10.8
Dale Ellis ,314,9,17,1983,1990,7,6.4
Dale Ellis ,314,9,17,1983,1991,8,3.2
Dale Ellis ,314,9,17,1983,1992,9,4.8
Dale Ellis ,314,9,17,1983,1993,10,6.4
Dale Ellis ,314,9,17,1983,1994,11,7.6
Dale Ellis ,314,9,17,1983,1995,12,3.4
Dale Ellis ,314,9,17,1983,1996,13,6.2
Dale Ellis ,314,9,17,1983,1997,14,3.1
Dale Ellis ,314,9,17,1983,1998,15,6
Dale Ellis ,314,9,17,1983,1999,16,2.4
Dale Ellis ,314,9,17,1983,2000,17,0.5
Dalibor Bagaric ,315,24,3,2000,2001,1,-0.7
Dalibor Bagaric ,315,24,3,2000,2002,2,-0.1
Dalibor Bagaric ,315,24,3,2000,2003,3,-0.1
Dallas Comegys ,316,21,2,1987,1988,1,-0.3
Dallas Comegys ,316,21,2,1987,1989,2,1.4
Damian Lillard ,317,6,4,2012,2013,1,5.8
Damian Lillard ,317,6,4,2012,2014,2,9.6
Damian Lillard ,317,6,4,2012,2015,3,10.6
Damian Lillard ,317,6,4,2012,2016,4,9.2
Damien Inglis ,318,31,1,2014,2016,2,-0.1
Damion James ,319,24,4,2010,2011,1,0.1
Damion James ,319,24,4,2010,2012,2,-0.2
Damion James ,319,24,4,2010,2013,3,0
Damion James ,319,24,4,2010,2014,4,0
Damon Stoudamire ,320,7,13,1995,1996,1,4.3
Damon Stoudamire ,320,7,13,1995,1997,2,7.6
Damon Stoudamire ,320,7,13,1995,1998,3,4.7
Damon Stoudamire ,320,7,13,1995,1999,4,3.6
Damon Stoudamire ,320,7,13,1995,2000,5,6.1
Damon Stoudamire ,320,7,13,1995,2001,6,6.7
Damon Stoudamire ,320,7,13,1995,2002,7,6.6
Damon Stoudamire ,320,7,13,1995,2003,8,1.6
Damon Stoudamire ,320,7,13,1995,2004,9,5.9
Damon Stoudamire ,320,7,13,1995,2005,10,5.7
Damon Stoudamire ,320,7,13,1995,2006,11,1.7
Damon Stoudamire ,320,7,13,1995,2007,12,1.1
Damon Stoudamire ,320,7,13,1995,2008,13,-0.1
Damone Brown ,321,36,4,2001,2002,1,-0.1
Damone Brown ,321,36,4,2001,2003,2,-0.2
Damone Brown ,321,36,4,2001,2004,3,-0.1
Damone Brown ,321,36,4,2001,2005,4,-0.2
Dan Dickau ,322,28,6,2002,2003,1,0
Dan Dickau ,322,28,6,2002,2004,2,0
Dan Dickau ,322,28,6,2002,2005,3,3.5
Dan Dickau ,322,28,6,2002,2006,4,0.4
Dan Dickau ,322,28,6,2002,2007,5,0.4
Dan Dickau ,322,28,6,2002,2008,6,1.5
Dan Gadzuric ,323,33,10,2002,2003,1,1.2
Dan Gadzuric ,323,33,10,2002,2004,2,3.7
Dan Gadzuric ,323,33,10,2002,2005,3,5.2
Dan Gadzuric ,323,33,10,2002,2006,4,2.5
Dan Gadzuric ,323,33,10,2002,2007,5,0.8
Dan Gadzuric ,323,33,10,2002,2008,6,0.1
Dan Gadzuric ,323,33,10,2002,2009,7,1.8
Dan Gadzuric ,323,33,10,2002,2010,8,0.5
Dan Gadzuric ,323,33,10,2002,2011,9,0.1
Dan Gadzuric ,323,33,10,2002,2012,10,0
Dan Langhi ,324,31,4,2000,2001,1,-0.1
Dan Langhi ,324,31,4,2000,2002,2,0
Dan Langhi ,324,31,4,2000,2003,3,0.4
Dan Langhi ,324,31,4,2000,2004,4,-0.1
Dan Majerle ,325,14,14,1988,1989,1,2.5
Dan Majerle ,325,14,14,1988,1990,2,5.5
Dan Majerle ,325,14,14,1988,1991,3,7.2
Dan Majerle ,325,14,14,1988,1992,4,9.8
Dan Majerle ,325,14,14,1988,1993,5,9.8
Dan Majerle ,325,14,14,1988,1994,6,7.3
Dan Majerle ,325,14,14,1988,1995,7,7.7
Dan Majerle ,325,14,14,1988,1996,8,5.5
Dan Majerle ,325,14,14,1988,1997,9,3.5
Dan Majerle ,325,14,14,1988,1998,10,5.3
Dan Majerle ,325,14,14,1988,1999,11,3.5
Dan Majerle ,325,14,14,1988,2000,12,6.1
Dan Majerle ,325,14,14,1988,2001,13,2.6
Dan Majerle ,325,14,14,1988,2002,14,2.1
Dana Barros ,326,16,14,1989,1990,1,1.8
Dana Barros ,326,16,14,1989,1991,2,2.5
Dana Barros ,326,16,14,1989,1992,3,3.6
Dana Barros ,326,16,14,1989,1993,4,3.5
Dana Barros ,326,16,14,1989,1994,5,4.7
Dana Barros ,326,16,14,1989,1995,6,12.7
Dana Barros ,326,16,14,1989,1996,7,5.6
Dana Barros ,326,16,14,1989,1997,8,1
Dana Barros ,326,16,14,1989,1998,9,5.6
Dana Barros ,326,16,14,1989,1999,10,3.4
Dana Barros ,326,16,14,1989,2000,11,2.4
Dana Barros ,326,16,14,1989,2001,12,2.3
Dana Barros ,326,16,14,1989,2002,13,0.5
Dana Barros ,326,16,14,1989,2004,15,0.1
Daniel Ewing ,327,32,2,2005,2006,1,0.3
Daniel Ewing ,327,32,2,2005,2007,2,0.5
Daniel Gibson ,328,42,7,2006,2007,1,2
Daniel Gibson ,328,42,7,2006,2008,2,4.1
Daniel Gibson ,328,42,7,2006,2009,3,3.8
Daniel Gibson ,328,42,7,2006,2010,4,2.6
Daniel Gibson ,328,42,7,2006,2011,5,2.4
Daniel Gibson ,328,42,7,2006,2012,6,0.5
Daniel Gibson ,328,42,7,2006,2013,7,0.5
Daniel Orton ,329,29,3,2010,2012,2,0.5
Daniel Orton ,329,29,3,2010,2013,3,0.3
Daniel Orton ,329,29,3,2010,2014,4,0.3
Danilo Gallinari ,330,6,7,2008,2009,1,1
Danilo Gallinari ,330,6,7,2008,2010,2,5.6
Danilo Gallinari ,330,6,7,2008,2011,3,6.1
Danilo Gallinari ,330,6,7,2008,2012,4,3.9
Danilo Gallinari ,330,6,7,2008,2013,5,7.2
Danilo Gallinari ,330,6,7,2008,2015,7,3.9
Danilo Gallinari ,330,6,7,2008,2016,8,6.3
Danny Ainge ,331,31,14,1981,1982,1,0.5
Danny Ainge ,331,31,14,1981,1983,2,5.2
Danny Ainge ,331,31,14,1981,1984,3,1.8
Danny Ainge ,331,31,14,1981,1985,4,6.6
Danny Ainge ,331,31,14,1981,1986,5,6.8
Danny Ainge ,331,31,14,1981,1987,6,6.7
Danny Ainge ,331,31,14,1981,1988,7,8.6
Danny Ainge ,331,31,14,1981,1989,8,6.7
Danny Ainge ,331,31,14,1981,1990,9,4.8
Danny Ainge ,331,31,14,1981,1991,10,6.2
Danny Ainge ,331,31,14,1981,1992,11,5.2
Danny Ainge ,331,31,14,1981,1993,12,6.2
Danny Ainge ,331,31,14,1981,1994,13,2.8
Danny Ainge ,331,31,14,1981,1995,14,3.4
Danny Ferry ,332,2,13,1989,1991,2,1
Danny Ferry ,332,2,13,1989,1992,3,1.3
Danny Ferry ,332,2,13,1989,1993,4,3.6
Danny Ferry ,332,2,13,1989,1994,5,1.7
Danny Ferry ,332,2,13,1989,1995,6,3.9
Danny Ferry ,332,2,13,1989,1996,7,5.5
Danny Ferry ,332,2,13,1989,1997,8,5.6
Danny Ferry ,332,2,13,1989,1998,9,1
Danny Ferry ,332,2,13,1989,1999,10,1.7
Danny Ferry ,332,2,13,1989,2000,11,2.7
Danny Ferry ,332,2,13,1989,2001,12,4.1
Danny Ferry ,332,2,13,1989,2002,13,2.3
Danny Ferry ,332,2,13,1989,2003,14,0.3
Danny Fortson ,333,10,10,1997,1998,1,1.9
Danny Fortson ,333,10,10,1997,1999,2,4.4
Danny Fortson ,333,10,10,1997,2000,3,3.5
Danny Fortson ,333,10,10,1997,2001,4,1.1
Danny Fortson ,333,10,10,1997,2002,5,4.5
Danny Fortson ,333,10,10,1997,2003,6,0.2
Danny Fortson ,333,10,10,1997,2004,7,2.3
Danny Fortson ,333,10,10,1997,2005,8,4.3
Danny Fortson ,333,10,10,1997,2006,9,0.2
Danny Fortson ,333,10,10,1997,2007,10,0
Danny Granger ,334,17,10,2005,2006,1,5.1
Danny Granger ,334,17,10,2005,2007,2,6.5
Danny Granger ,334,17,10,2005,2008,3,7.3
Danny Granger ,334,17,10,2005,2009,4,8
Danny Granger ,334,17,10,2005,2010,5,6.2
Danny Granger ,334,17,10,2005,2011,6,6.9
Danny Granger ,334,17,10,2005,2012,7,6.7
Danny Granger ,334,17,10,2005,2013,8,-0.1
Danny Granger ,334,17,10,2005,2014,9,1.3
Danny Granger ,334,17,10,2005,2015,10,0.6
Danny Green ,335,46,7,2009,2010,1,0.2
Danny Green ,335,46,7,2009,2011,2,0.1
Danny Green ,335,46,7,2009,2012,3,4.5
Danny Green ,335,46,7,2009,2013,4,5.9
Danny Green ,335,46,7,2009,2014,5,4.2
Danny Green ,335,46,7,2009,2015,6,7.8
Danny Green ,335,46,7,2009,2016,7,4.2
Danny Manning ,336,1,15,1988,1989,1,0.7
Danny Manning ,336,1,15,1988,1990,2,5.3
Danny Manning ,336,1,15,1988,1991,3,5.2
Danny Manning ,336,1,15,1988,1992,4,9.8
Danny Manning ,336,1,15,1988,1993,5,7.9
Danny Manning ,336,1,15,1988,1994,6,3.5
Danny Manning ,336,1,15,1988,1995,7,3.4
Danny Manning ,336,1,15,1988,1996,8,0.4
Danny Manning ,336,1,15,1988,1997,9,5.2
Danny Manning ,336,1,15,1988,1998,10,6.5
Danny Manning ,336,1,15,1988,1999,11,2.6
Danny Manning ,336,1,15,1988,2000,12,1
Danny Manning ,336,1,15,1988,2001,13,2.6
Danny Manning ,336,1,15,1988,2002,14,0.8
Danny Manning ,336,1,15,1988,2003,15,0.2
Danny Schayes ,337,13,18,1981,1982,1,1.7
Danny Schayes ,337,13,18,1981,1983,2,2
Danny Schayes ,337,13,18,1981,1984,3,2.8
Danny Schayes ,337,13,18,1981,1985,4,1.2
Danny Schayes ,337,13,18,1981,1986,5,4.6
Danny Schayes ,337,13,18,1981,1987,6,3.9
Danny Schayes ,337,13,18,1981,1988,7,8.8
Danny Schayes ,337,13,18,1981,1989,8,5.6
Danny Schayes ,337,13,18,1981,1990,9,4.5
Danny Schayes ,337,13,18,1981,1991,10,6.8
Danny Schayes ,337,13,18,1981,1992,11,0.9
Danny Schayes ,337,13,18,1981,1993,12,1.4
Danny Schayes ,337,13,18,1981,1994,13,0
Danny Schayes ,337,13,18,1981,1995,14,1.4
Danny Schayes ,337,13,18,1981,1996,15,0.4
Danny Schayes ,337,13,18,1981,1997,16,0.6
Danny Schayes ,337,13,18,1981,1998,17,2
Danny Schayes ,337,13,18,1981,1999,18,0
Danny Vranes ,338,5,7,1981,1982,1,2.4
Danny Vranes ,338,5,7,1981,1983,2,4.2
Danny Vranes ,338,5,7,1981,1984,3,3.4
Danny Vranes ,338,5,7,1981,1985,4,1.8
Danny Vranes ,338,5,7,1981,1986,5,2.1
Danny Vranes ,338,5,7,1981,1987,6,0.8
Danny Vranes ,338,5,7,1981,1988,7,0.6
Danny Young ,339,39,10,1984,1985,1,-0.1
Danny Young ,339,39,10,1984,1986,2,4.8
Danny Young ,339,39,10,1984,1987,3,2.9
Danny Young ,339,39,10,1984,1988,4,2.4
Danny Young ,339,39,10,1984,1989,5,1.8
Danny Young ,339,39,10,1984,1990,6,3
Danny Young ,339,39,10,1984,1991,7,1.8
Danny Young ,339,39,10,1984,1992,8,1.9
Danny Young ,339,39,10,1984,1993,9,1.4
Danny Young ,339,39,10,1984,1995,11,0.2
Dante Cunningham ,340,33,7,2009,2010,1,1.9
Dante Cunningham ,340,33,7,2009,2011,2,2
Dante Cunningham ,340,33,7,2009,2012,3,3.4
Dante Cunningham ,340,33,7,2009,2013,4,3.5
Dante Cunningham ,340,33,7,2009,2014,5,2.9
Dante Cunningham ,340,33,7,2009,2015,6,1.6
Dante Cunningham ,340,33,7,2009,2016,7,2.1
Dante Exum ,341,5,1,2014,2015,1,-0.1
Darington Hobson ,342,37,1,2010,2012,2,-0.2
Darius Miles ,343,3,7,2000,2001,1,3
Darius Miles ,343,3,7,2000,2002,2,3.4
Darius Miles ,343,3,7,2000,2003,3,-1.3
Darius Miles ,343,3,7,2000,2004,4,3.6
Darius Miles ,343,3,7,2000,2005,5,1.3
Darius Miles ,343,3,7,2000,2006,6,-1
Darius Miles ,343,3,7,2000,2009,9,0.5
Darius Miller ,344,46,3,2012,2013,1,0.5
Darius Miller ,344,46,3,2012,2014,2,0.8
Darius Miller ,344,46,3,2012,2015,3,-0.1
Darius Morris ,345,41,4,2011,2012,1,-0.2
Darius Morris ,345,41,4,2011,2013,2,0.2
Darius Morris ,345,41,4,2011,2014,3,0
Darius Morris ,345,41,4,2011,2015,4,-0.4
Darius Songaila ,346,49,8,2002,2004,2,2.6
Darius Songaila ,346,49,8,2002,2005,3,4.3
Darius Songaila ,346,49,8,2002,2006,4,2.5
Darius Songaila ,346,49,8,2002,2007,5,1.1
Darius Songaila ,346,49,8,2002,2008,6,1.7
Darius Songaila ,346,49,8,2002,2009,7,2.4
Darius Songaila ,346,49,8,2002,2010,8,1.3
Darius Songaila ,346,49,8,2002,2011,9,0
Darko Milicic ,347,2,10,2003,2004,1,-0.2
Darko Milicic ,347,2,10,2003,2005,2,-0.2
Darko Milicic ,347,2,10,2003,2006,3,1.2
Darko Milicic ,347,2,10,2003,2007,4,3.3
Darko Milicic ,347,2,10,2003,2008,5,0.2
Darko Milicic ,347,2,10,2003,2009,6,1.9
Darko Milicic ,347,2,10,2003,2010,7,0.7
Darko Milicic ,347,2,10,2003,2011,8,0.2
Darko Milicic ,347,2,10,2003,2012,9,0
Darko Milicic ,347,2,10,2003,2013,10,-0.1
Darnell Mee ,348,34,2,1993,1994,1,-0.1
Darnell Mee ,348,34,2,1993,1995,2,0
Darnell Valentine ,349,16,9,1981,1982,1,1.7
Darnell Valentine ,349,16,9,1981,1983,2,3.4
Darnell Valentine ,349,16,9,1981,1984,3,3.7
Darnell Valentine ,349,16,9,1981,1985,4,5
Darnell Valentine ,349,16,9,1981,1986,5,1
Darnell Valentine ,349,16,9,1981,1987,6,1.1
Darnell Valentine ,349,16,9,1981,1988,7,1.5
Darnell Valentine ,349,16,9,1981,1989,8,1.7
Darnell Valentine ,349,16,9,1981,1991,10,3.1
Darrell Arthur ,350,27,7,2008,2009,1,1.7
Darrell Arthur ,350,27,7,2008,2010,2,0.3
Darrell Arthur ,350,27,7,2008,2011,3,3.8
Darrell Arthur ,350,27,7,2008,2013,5,1.7
Darrell Arthur ,350,27,7,2008,2014,6,0.7
Darrell Arthur ,350,27,7,2008,2015,7,0.9
Darrell Arthur ,350,27,7,2008,2016,8,2.3
Darrell Griffith ,351,2,10,1980,1981,1,0.4
Darrell Griffith ,351,2,10,1980,1982,2,2.1
Darrell Griffith ,351,2,10,1980,1983,3,2.8
Darrell Griffith ,351,2,10,1980,1984,4,3.5
Darrell Griffith ,351,2,10,1980,1985,5,3.5
Darrell Griffith ,351,2,10,1980,1987,7,2.5
Darrell Griffith ,351,2,10,1980,1988,8,0.8
Darrell Griffith ,351,2,10,1980,1989,9,3.9
Darrell Griffith ,351,2,10,1980,1990,10,2.5
Darrell Griffith ,351,2,10,1980,1991,11,0
Darrell Lockhart ,352,35,1,1983,1984,1,0
Darrell Walker ,353,12,10,1983,1984,1,2.3
Darrell Walker ,353,12,10,1983,1985,2,2.8
Darrell Walker ,353,12,10,1983,1986,3,2.1
Darrell Walker ,353,12,10,1983,1987,4,3.8
Darrell Walker ,353,12,10,1983,1988,5,0.8
Darrell Walker ,353,12,10,1983,1989,6,3.7
Darrell Walker ,353,12,10,1983,1990,7,6.3
Darrell Walker ,353,12,10,1983,1991,8,2.9
Darrell Walker ,353,12,10,1983,1992,9,2.4
Darrell Walker ,353,12,10,1983,1993,10,0.2
Darren Collison ,354,21,7,2009,2010,1,2.9
Darren Collison ,354,21,7,2009,2011,2,4.3
Darren Collison ,354,21,7,2009,2012,3,3.8
Darren Collison ,354,21,7,2009,2013,4,5.6
Darren Collison ,354,21,7,2009,2014,5,5.9
Darren Collison ,354,21,7,2009,2015,6,3.8
Darren Collison ,354,21,7,2009,2016,7,5.2
Darren Morningstar ,355,47,1,1992,1994,2,0.4
Darren Tillis ,356,23,2,1982,1983,1,0.5
Darren Tillis ,356,23,2,1982,1984,2,0.5
Darrin Hancock ,357,38,3,1994,1995,1,0.4
Darrin Hancock ,357,38,3,1994,1996,2,0.5
Darrin Hancock ,357,38,3,1994,1997,3,0.2
Darrun Hilliard ,358,38,1,2015,2016,1,0.5
Dave Corzine ,359,18,13,1978,1979,1,1.1
Dave Corzine ,359,18,13,1978,1980,2,0.9
Dave Corzine ,359,18,13,1978,1981,3,5.1
Dave Corzine ,359,18,13,1978,1982,4,5.2
Dave Corzine ,359,18,13,1978,1983,5,4
Dave Corzine ,359,18,13,1978,1984,6,4.7
Dave Corzine ,359,18,13,1978,1985,7,2.9
Dave Corzine ,359,18,13,1978,1986,8,2.9
Dave Corzine ,359,18,13,1978,1987,9,4.2
Dave Corzine ,359,18,13,1978,1988,10,4.9
Dave Corzine ,359,18,13,1978,1989,11,1.4
Dave Corzine ,359,18,13,1978,1990,12,-0.2
Dave Corzine ,359,18,13,1978,1991,13,0.4
Dave Feitl ,360,43,5,1986,1987,1,0.5
Dave Feitl ,360,43,5,1986,1988,2,0.3
Dave Feitl ,360,43,5,1986,1989,3,0.4
Dave Feitl ,360,43,5,1986,1991,5,0.2
Dave Feitl ,360,43,5,1986,1992,6,0.1
Dave Greenwood ,361,2,12,1979,1980,1,6.5
Dave Greenwood ,361,2,12,1979,1981,2,7.1
Dave Greenwood ,361,2,12,1979,1982,3,6.5
Dave Greenwood ,361,2,12,1979,1983,4,3.6
Dave Greenwood ,361,2,12,1979,1984,5,5.7
Dave Greenwood ,361,2,12,1979,1985,6,2
Dave Greenwood ,361,2,12,1979,1986,7,3.4
Dave Greenwood ,361,2,12,1979,1987,8,6.2
Dave Greenwood ,361,2,12,1979,1988,9,1.1
Dave Greenwood ,361,2,12,1979,1989,10,2.2
Dave Greenwood ,361,2,12,1979,1990,11,0.4
Dave Greenwood ,361,2,12,1979,1991,12,1.7
Dave Jamerson ,362,15,3,1990,1991,1,0.1
Dave Jamerson ,362,15,3,1990,1992,2,0.2
Dave Jamerson ,362,15,3,1990,1994,4,-0.1
Dave Johnson ,363,26,2,1992,1993,1,-0.1
Dave Johnson ,363,26,2,1992,1994,2,-0.2
Dave Magley ,364,28,1,1982,1983,1,-0.1
David Andersen ,365,36,2,2002,2010,8,1.3
David Andersen ,365,36,2,2002,2011,9,0.3
David Burns ,366,49,1,1981,1982,1,-0.1
David Harrison ,367,29,4,2004,2005,1,1.4
David Harrison ,367,29,4,2004,2006,2,1.5
David Harrison ,367,29,4,2004,2007,3,-0.2
David Harrison ,367,29,4,2004,2008,4,0.4
David Lee ,368,30,11,2005,2006,1,2.7
David Lee ,368,30,11,2005,2007,2,6.9
David Lee ,368,30,11,2005,2008,3,7.4
David Lee ,368,30,11,2005,2009,4,9
David Lee ,368,30,11,2005,2010,5,10.3
David Lee ,368,30,11,2005,2011,6,6
David Lee ,368,30,11,2005,2012,7,5
David Lee ,368,30,11,2005,2013,8,9.1
David Lee ,368,30,11,2005,2014,9,7.6
David Lee ,368,30,11,2005,2015,10,3.2
David Lee ,368,30,11,2005,2016,11,3
David Noel ,369,39,1,2006,2007,1,0.4
David Rivers ,370,25,3,1988,1989,1,0
David Rivers ,370,25,3,1988,1990,2,-0.2
David Rivers ,370,25,3,1988,1992,4,-0.1
David Thirdkill ,371,15,5,1982,1983,1,0.3
David Thirdkill ,371,15,5,1982,1984,2,0
David Thirdkill ,371,15,5,1982,1985,3,0
David Thirdkill ,371,15,5,1982,1986,4,1
David Thirdkill ,371,15,5,1982,1987,5,-0.1
David Vaughn ,372,25,4,1995,1996,1,-0.1
David Vaughn ,372,25,4,1995,1997,2,0.1
David Vaughn ,372,25,4,1995,1998,3,0.4
David Vaughn ,372,25,4,1995,1999,4,0.2
David West ,373,18,13,2003,2004,1,2.8
David West ,373,18,13,2003,2005,2,0.2
David West ,373,18,13,2003,2006,3,7.4
David West ,373,18,13,2003,2007,4,5.2
David West ,373,18,13,2003,2008,5,8.4
David West ,373,18,13,2003,2009,6,7.8
David West ,373,18,13,2003,2010,7,7.5
David West ,373,18,13,2003,2011,8,7.8
David West ,373,18,13,2003,2012,9,5.9
David West ,373,18,13,2003,2013,10,9.1
David West ,373,18,13,2003,2014,11,8.1
David West ,373,18,13,2003,2015,12,4.3
David West ,373,18,13,2003,2016,13,5.4
David Wingate ,374,44,15,1986,1987,1,1.4
David Wingate ,374,44,15,1986,1988,2,-0.5
David Wingate ,374,44,15,1986,1989,3,0.2
David Wingate ,374,44,15,1986,1990,4,1.9
David Wingate ,374,44,15,1986,1991,5,0.1
David Wingate ,374,44,15,1986,1992,6,2.4
David Wingate ,374,44,15,1986,1993,7,2.3
David Wingate ,374,44,15,1986,1994,8,1
David Wingate ,374,44,15,1986,1995,9,0.4
David Wingate ,374,44,15,1986,1996,10,0.6
David Wingate ,374,44,15,1986,1997,11,1.7
David Wingate ,374,44,15,1986,1998,12,0.3
David Wingate ,374,44,15,1986,1999,13,0
David Wingate ,374,44,15,1986,2000,14,-0.1
David Wingate ,374,44,15,1986,2001,15,0.1
Dean Garrett ,375,38,6,1988,1997,9,6.2
Dean Garrett ,375,38,6,1988,1998,10,2.2
Dean Garrett ,375,38,6,1988,1999,11,2.9
Dean Garrett ,375,38,6,1988,2000,12,1
Dean Garrett ,375,38,6,1988,2001,13,1.9
Dean Garrett ,375,38,6,1988,2002,14,-0.1
DeAndre Jordan ,376,35,8,2008,2009,1,1.3
DeAndre Jordan ,376,35,8,2008,2010,2,1.5
DeAndre Jordan ,376,35,8,2008,2011,3,5.2
DeAndre Jordan ,376,35,8,2008,2012,4,5.6
DeAndre Jordan ,376,35,8,2008,2013,5,6.2
DeAndre Jordan ,376,35,8,2008,2014,6,11.1
DeAndre Jordan ,376,35,8,2008,2015,7,12.8
DeAndre Jordan ,376,35,8,2008,2016,8,11.5
Dee Brown ,377,19,12,1990,1991,1,3.5
Dee Brown ,377,19,12,1990,1992,2,1
Dee Brown ,377,19,12,1990,1993,3,6.4
Dee Brown ,377,19,12,1990,1994,4,6.4
Dee Brown ,377,19,12,1990,1995,5,6.8
Dee Brown ,377,19,12,1990,1996,6,2.4
Dee Brown ,377,19,12,1990,1997,7,0.3
Dee Brown ,377,19,12,1990,1998,8,3.4
Dee Brown ,377,19,12,1990,1999,9,2.5
Dee Brown ,377,19,12,1990,2000,10,0.8
Dee Brown ,377,19,12,1990,2001,11,0.2
Dee Brown ,377,19,12,1990,2002,12,-0.3
Dee Brown ,377,19,12,1990,2007,17,0.2
Dee Brown ,377,19,12,1990,2009,19,-0.1
Dee Brown Jr.,378,46,2,2006,2007,1,0.2
Dee Brown Jr.,378,46,2,2006,2009,3,-0.1
DeJuan Blair ,379,37,7,2009,2010,1,4.6
DeJuan Blair ,379,37,7,2009,2011,2,4.8
DeJuan Blair ,379,37,7,2009,2012,3,4
DeJuan Blair ,379,37,7,2009,2013,4,2.2
DeJuan Blair ,379,37,7,2009,2014,5,3.4
DeJuan Blair ,379,37,7,2009,2015,6,0.1
DeJuan Blair ,379,37,7,2009,2016,7,-0.1
Dell Curry ,380,15,16,1986,1987,1,0.5
Dell Curry ,380,15,16,1986,1988,2,2
Dell Curry ,380,15,16,1986,1989,3,0.9
Dell Curry ,380,15,16,1986,1990,4,1.8
Dell Curry ,380,15,16,1986,1991,5,2.7
Dell Curry ,380,15,16,1986,1992,6,3.2
Dell Curry ,380,15,16,1986,1993,7,3.4
Dell Curry ,380,15,16,1986,1994,8,5
Dell Curry ,380,15,16,1986,1995,9,3.3
Dell Curry ,380,15,16,1986,1996,10,5.1
Dell Curry ,380,15,16,1986,1997,11,3.8
Dell Curry ,380,15,16,1986,1998,12,1.7
Dell Curry ,380,15,16,1986,1999,13,2.6
Dell Curry ,380,15,16,1986,2000,14,2.2
Dell Curry ,380,15,16,1986,2001,15,2
Dell Curry ,380,15,16,1986,2002,16,1.2
Delon Wright ,381,20,1,2015,2016,1,0.6
Delonte West ,382,24,8,2004,2005,1,0.9
Delonte West ,382,24,8,2004,2006,2,5.7
Delonte West ,382,24,8,2004,2007,3,3.7
Delonte West ,382,24,8,2004,2008,4,1.3
Delonte West ,382,24,8,2004,2009,5,6.4
Delonte West ,382,24,8,2004,2010,6,3.3
Delonte West ,382,24,8,2004,2011,7,0.9
Delonte West ,382,24,8,2004,2012,8,2.2
DeMar DeRozan ,383,9,7,2009,2010,1,2.3
DeMar DeRozan ,383,9,7,2009,2011,2,3.2
DeMar DeRozan ,383,9,7,2009,2012,3,2.5
DeMar DeRozan ,383,9,7,2009,2013,4,4.7
DeMar DeRozan ,383,9,7,2009,2014,5,8.8
DeMar DeRozan ,383,9,7,2009,2015,6,4
DeMar DeRozan ,383,9,7,2009,2016,7,9.9
DeMarco Johnson ,384,38,1,1998,2000,2,-0.1
DeMarcus Cousins ,385,5,6,2010,2011,1,1.1
DeMarcus Cousins ,385,5,6,2010,2012,2,4.2
DeMarcus Cousins ,385,5,6,2010,2013,3,4.4
DeMarcus Cousins ,385,5,6,2010,2014,4,7.9
DeMarcus Cousins ,385,5,6,2010,2015,5,6
DeMarcus Cousins ,385,5,6,2010,2016,6,5.7
DeMarre Carroll ,386,27,7,2009,2010,1,0.5
DeMarre Carroll ,386,27,7,2009,2011,2,0.1
DeMarre Carroll ,386,27,7,2009,2012,3,0.5
DeMarre Carroll ,386,27,7,2009,2013,4,3.1
DeMarre Carroll ,386,27,7,2009,2014,5,5.8
DeMarre Carroll ,386,27,7,2009,2015,6,7
DeMarre Carroll ,386,27,7,2009,2016,7,1.2
Dennis Hopson ,387,3,5,1987,1988,1,-0.3
Dennis Hopson ,387,3,5,1987,1989,2,1.7
Dennis Hopson ,387,3,5,1987,1990,3,3.1
Dennis Hopson ,387,3,5,1987,1991,4,0.5
Dennis Hopson ,387,3,5,1987,1992,5,2.1
Dennis Schroder ,388,17,3,2013,2014,1,-0.7
Dennis Schroder ,388,17,3,2013,2015,2,2.5
Dennis Schroder ,388,17,3,2013,2016,3,2.2
Dennis Scott ,389,4,10,1990,1991,1,2.6
Dennis Scott ,389,4,10,1990,1992,2,0.7
Dennis Scott ,389,4,10,1990,1993,3,2.8
Dennis Scott ,389,4,10,1990,1994,4,5
Dennis Scott ,389,4,10,1990,1995,5,4.6
Dennis Scott ,389,4,10,1990,1996,6,8.8
Dennis Scott ,389,4,10,1990,1997,7,3.8
Dennis Scott ,389,4,10,1990,1998,8,2.4
Dennis Scott ,389,4,10,1990,1999,9,1.2
Dennis Scott ,389,4,10,1990,2000,10,1.5
Derek Anderson ,390,13,11,1997,1998,1,5.3
Derek Anderson ,390,13,11,1997,1999,2,2.1
Derek Anderson ,390,13,11,1997,2000,3,3.3
Derek Anderson ,390,13,11,1997,2001,4,9.9
Derek Anderson ,390,13,11,1997,2002,5,5.3
Derek Anderson ,390,13,11,1997,2003,6,8.1
Derek Anderson ,390,13,11,1997,2004,7,3.6
Derek Anderson ,390,13,11,1997,2005,8,1.3
Derek Anderson ,390,13,11,1997,2006,9,1.6
Derek Anderson ,390,13,11,1997,2007,10,2.9
Derek Anderson ,390,13,11,1997,2008,11,0.3
Derek Fisher ,391,24,18,1996,1997,1,1.1
Derek Fisher ,391,24,18,1996,1998,2,3.8
Derek Fisher ,391,24,18,1996,1999,3,1.7
Derek Fisher ,391,24,18,1996,2000,4,3.1
Derek Fisher ,391,24,18,1996,2001,5,1.8
Derek Fisher ,391,24,18,1996,2002,6,5.5
Derek Fisher ,391,24,18,1996,2003,7,5.2
Derek Fisher ,391,24,18,1996,2004,8,2.4
Derek Fisher ,391,24,18,1996,2005,9,3.7
Derek Fisher ,391,24,18,1996,2006,10,5.8
Derek Fisher ,391,24,18,1996,2007,11,3.9
Derek Fisher ,391,24,18,1996,2008,12,5.7
Derek Fisher ,391,24,18,1996,2009,13,6.3
Derek Fisher ,391,24,18,1996,2010,14,3.9
Derek Fisher ,391,24,18,1996,2011,15,3.7
Derek Fisher ,391,24,18,1996,2012,16,1.2
Derek Fisher ,391,24,18,1996,2013,17,0.4
Derek Fisher ,391,24,18,1996,2014,18,3.1
Derek Harper ,392,11,16,1983,1984,1,1.3
Derek Harper ,392,11,16,1983,1985,2,5.4
Derek Harper ,392,11,16,1983,1986,3,6.2
Derek Harper ,392,11,16,1983,1987,4,9.4
Derek Harper ,392,11,16,1983,1988,5,9.1
Derek Harper ,392,11,16,1983,1989,6,8
Derek Harper ,392,11,16,1983,1990,7,9.9
Derek Harper ,392,11,16,1983,1991,8,7.6
Derek Harper ,392,11,16,1983,1992,9,3.5
Derek Harper ,392,11,16,1983,1993,10,2.7
Derek Harper ,392,11,16,1983,1994,11,4
Derek Harper ,392,11,16,1983,1995,12,6.4
Derek Harper ,392,11,16,1983,1996,13,6.3
Derek Harper ,392,11,16,1983,1997,14,2.7
Derek Harper ,392,11,16,1983,1998,15,2.3
Derek Harper ,392,11,16,1983,1999,16,2
Derek Smith ,393,35,9,1982,1983,1,0
Derek Smith ,393,35,9,1982,1984,2,2.6
Derek Smith ,393,35,9,1982,1985,3,8
Derek Smith ,393,35,9,1982,1986,4,0.8
Derek Smith ,393,35,9,1982,1987,5,1.6
Derek Smith ,393,35,9,1982,1988,6,1.5
Derek Smith ,393,35,9,1982,1989,7,0.9
Derek Smith ,393,35,9,1982,1990,8,2.9
Derek Smith ,393,35,9,1982,1991,9,0
Derek Strong ,394,47,10,1990,1992,2,0
Derek Strong ,394,47,10,1990,1993,3,1.5
Derek Strong ,394,47,10,1990,1994,4,2.1
Derek Strong ,394,47,10,1990,1995,5,2.4
Derek Strong ,394,47,10,1990,1996,6,1.9
Derek Strong ,394,47,10,1990,1997,7,4.1
Derek Strong ,394,47,10,1990,1998,8,4.4
Derek Strong ,394,47,10,1990,1999,9,1.6
Derek Strong ,394,47,10,1990,2000,10,0.2
Derek Strong ,394,47,10,1990,2001,11,0.3
DerMarr Johnson ,395,6,7,2000,2001,1,0
DerMarr Johnson ,395,6,7,2000,2002,2,1.7
DerMarr Johnson ,395,6,7,2000,2004,4,0.4
DerMarr Johnson ,395,6,7,2000,2005,5,3.2
DerMarr Johnson ,395,6,7,2000,2006,6,1.3
DerMarr Johnson ,395,6,7,2000,2007,7,-0.3
DerMarr Johnson ,395,6,7,2000,2008,8,0.1
Deron Williams ,396,3,11,2005,2006,1,2.8
Deron Williams ,396,3,11,2005,2007,2,7.2
Deron Williams ,396,3,11,2005,2008,3,11.3
Deron Williams ,396,3,11,2005,2009,4,8.4
Deron Williams ,396,3,11,2005,2010,5,10.3
Deron Williams ,396,3,11,2005,2011,6,7.3
Deron Williams ,396,3,11,2005,2012,7,4.1
Deron Williams ,396,3,11,2005,2013,8,10.9
Deron Williams ,396,3,11,2005,2014,9,5.4
Deron Williams ,396,3,11,2005,2015,10,3.6
Deron Williams ,396,3,11,2005,2016,11,3.7
Derrick Alston ,397,33,3,1994,1995,1,1
Derrick Alston ,397,33,3,1994,1996,2,1.7
Derrick Alston ,397,33,3,1994,1997,3,-0.1
Derrick Brown ,398,40,3,2009,2010,1,1.3
Derrick Brown ,398,40,3,2009,2011,2,1
Derrick Brown ,398,40,3,2009,2012,3,2.3
Derrick Byars ,399,42,1,2007,2012,5,0.1
Derrick Chievous ,400,16,3,1988,1989,1,1.6
Derrick Chievous ,400,16,3,1988,1990,2,1.2
Derrick Chievous ,400,16,3,1988,1991,3,-0.1
Derrick Coleman ,401,1,15,1990,1991,1,5.8
Derrick Coleman ,401,1,15,1990,1992,2,5.6
Derrick Coleman ,401,1,15,1990,1993,3,9.5
Derrick Coleman ,401,1,15,1990,1994,4,9.9
Derrick Coleman ,401,1,15,1990,1995,5,5.1
Derrick Coleman ,401,1,15,1990,1996,6,-0.2
Derrick Coleman ,401,1,15,1990,1997,7,3.3
Derrick Coleman ,401,1,15,1990,1998,8,4.4
Derrick Coleman ,401,1,15,1990,1999,9,2
Derrick Coleman ,401,1,15,1990,2000,10,6.5
Derrick Coleman ,401,1,15,1990,2001,11,1.2
Derrick Coleman ,401,1,15,1990,2002,12,5.9
Derrick Coleman ,401,1,15,1990,2003,13,4.5
Derrick Coleman ,401,1,15,1990,2004,14,0.8
Derrick Coleman ,401,1,15,1990,2005,15,-0.1
Derrick Favors ,402,3,6,2010,2011,1,2.9
Derrick Favors ,402,3,6,2010,2012,2,3
Derrick Favors ,402,3,6,2010,2013,3,4.4
Derrick Favors ,402,3,6,2010,2014,4,5.1
Derrick Favors ,402,3,6,2010,2015,5,8.3
Derrick Favors ,402,3,6,2010,2016,6,7.1
Derrick McKey ,403,9,15,1987,1988,1,4.1
Derrick McKey ,403,9,15,1987,1989,2,7.4
Derrick McKey ,403,9,15,1987,1990,3,6.3
Derrick McKey ,403,9,15,1987,1991,4,6.4
Derrick McKey ,403,9,15,1987,1992,5,3.9
Derrick McKey ,403,9,15,1987,1993,6,6.6
Derrick McKey ,403,9,15,1987,1994,7,5
Derrick McKey ,403,9,15,1987,1995,8,7.4
Derrick McKey ,403,9,15,1987,1996,9,5.7
Derrick McKey ,403,9,15,1987,1997,10,1.8
Derrick McKey ,403,9,15,1987,1998,11,2.1
Derrick McKey ,403,9,15,1987,1999,12,0.4
Derrick McKey ,403,9,15,1987,2000,13,1.6
Derrick McKey ,403,9,15,1987,2001,14,1.4
Derrick McKey ,403,9,15,1987,2002,15,1.6
Derrick Rose ,404,1,7,2008,2009,1,4.9
Derrick Rose ,404,1,7,2008,2010,2,6
Derrick Rose ,404,1,7,2008,2011,3,13.1
Derrick Rose ,404,1,7,2008,2012,4,6
Derrick Rose ,404,1,7,2008,2014,6,-0.2
Derrick Rose ,404,1,7,2008,2015,7,1.2
Derrick Rose ,404,1,7,2008,2016,8,0.4
Derrick Williams ,405,2,5,2011,2012,1,1.8
Derrick Williams ,405,2,5,2011,2013,2,3
Derrick Williams ,405,2,5,2011,2014,3,2.6
Derrick Williams ,405,2,5,2011,2015,4,2.1
Derrick Williams ,405,2,5,2011,2016,5,3.6
Derrick Zimmerman ,406,40,1,2003,2006,3,0
DeSagana Diop ,407,8,12,2001,2002,1,-0.3
DeSagana Diop ,407,8,12,2001,2003,2,-0.2
DeSagana Diop ,407,8,12,2001,2004,3,1
DeSagana Diop ,407,8,12,2001,2005,4,0
DeSagana Diop ,407,8,12,2001,2006,5,4.1
DeSagana Diop ,407,8,12,2001,2007,6,3.8
DeSagana Diop ,407,8,12,2001,2008,7,3
DeSagana Diop ,407,8,12,2001,2009,8,1.4
DeSagana Diop ,407,8,12,2001,2010,9,0.4
DeSagana Diop ,407,8,12,2001,2011,10,-0.1
DeSagana Diop ,407,8,12,2001,2012,11,-0.2
DeSagana Diop ,407,8,12,2001,2013,12,-0.1
DeShawn Stevenson ,408,23,13,2000,2001,1,-0.4
DeShawn Stevenson ,408,23,13,2000,2002,2,-0.2
DeShawn Stevenson ,408,23,13,2000,2003,3,-0.1
DeShawn Stevenson ,408,23,13,2000,2004,4,1.5
DeShawn Stevenson ,408,23,13,2000,2005,5,-0.1
DeShawn Stevenson ,408,23,13,2000,2006,6,2.4
DeShawn Stevenson ,408,23,13,2000,2007,7,3.1
DeShawn Stevenson ,408,23,13,2000,2008,8,4.1
DeShawn Stevenson ,408,23,13,2000,2009,9,-0.6
DeShawn Stevenson ,408,23,13,2000,2010,10,-0.4
DeShawn Stevenson ,408,23,13,2000,2011,11,1.8
DeShawn Stevenson ,408,23,13,2000,2012,12,-0.3
DeShawn Stevenson ,408,23,13,2000,2013,13,1.5
Desmond Mason ,409,17,10,2000,2001,1,1.7
Desmond Mason ,409,17,10,2000,2002,2,4.7
Desmond Mason ,409,17,10,2000,2003,3,5.2
Desmond Mason ,409,17,10,2000,2004,4,5.7
Desmond Mason ,409,17,10,2000,2005,5,4.3
Desmond Mason ,409,17,10,2000,2006,6,-0.2
Desmond Mason ,409,17,10,2000,2007,7,0.6
Desmond Mason ,409,17,10,2000,2008,8,1.5
Desmond Mason ,409,17,10,2000,2009,9,-0.3
Desmond Mason ,409,17,10,2000,2010,10,0
Detlef Schrempf ,410,8,16,1985,1986,1,0.8
Detlef Schrempf ,410,8,16,1985,1987,2,4
Detlef Schrempf ,410,8,16,1985,1988,3,3.6
Detlef Schrempf ,410,8,16,1985,1989,4,4.4
Detlef Schrempf ,410,8,16,1985,1990,5,8.1
Detlef Schrempf ,410,8,16,1985,1991,6,9
Detlef Schrempf ,410,8,16,1985,1992,7,9.8
Detlef Schrempf ,410,8,16,1985,1993,8,10.4
Detlef Schrempf ,410,8,16,1985,1994,9,8.4
Detlef Schrempf ,410,8,16,1985,1995,10,12.9
Detlef Schrempf ,410,8,16,1985,1996,11,8.2
Detlef Schrempf ,410,8,16,1985,1997,12,8
Detlef Schrempf ,410,8,16,1985,1998,13,10.4
Detlef Schrempf ,410,8,16,1985,1999,14,5.8
Detlef Schrempf ,410,8,16,1985,2000,15,5.2
Detlef Schrempf ,410,8,16,1985,2001,16,0.5
Devean George ,411,23,11,1999,2000,1,0.7
Devean George ,411,23,11,1999,2001,2,-0.3
Devean George ,411,23,11,1999,2002,3,4.2
Devean George ,411,23,11,1999,2003,4,2.7
Devean George ,411,23,11,1999,2004,5,3.4
Devean George ,411,23,11,1999,2005,6,0.3
Devean George ,411,23,11,1999,2006,7,2.6
Devean George ,411,23,11,1999,2007,8,2.1
Devean George ,411,23,11,1999,2008,9,0.7
Devean George ,411,23,11,1999,2009,10,0.6
Devean George ,411,23,11,1999,2010,11,1.3
Devin Booker ,412,13,1,2015,2016,1,1.9
Devin Durrant ,413,25,2,1984,1985,1,-0.1
Devin Durrant ,413,25,2,1984,1986,2,-0.1
Devin Ebanks ,414,43,3,2010,2011,1,0.4
Devin Ebanks ,414,43,3,2010,2012,2,0.3
Devin Ebanks ,414,43,3,2010,2013,3,-0.1
Devin Harris ,415,5,12,2004,2005,1,2.7
Devin Harris ,415,5,12,2004,2006,2,3.7
Devin Harris ,415,5,12,2004,2007,3,6.5
Devin Harris ,415,5,12,2004,2008,4,5.6
Devin Harris ,415,5,12,2004,2009,5,7.5
Devin Harris ,415,5,12,2004,2010,6,2.7
Devin Harris ,415,5,12,2004,2011,7,4.2
Devin Harris ,415,5,12,2004,2012,8,4.2
Devin Harris ,415,5,12,2004,2013,9,3.3
Devin Harris ,415,5,12,2004,2014,10,1.6
Devin Harris ,415,5,12,2004,2015,11,4.2
Devin Harris ,415,5,12,2004,2016,12,2.5
DeWayne Scales ,416,36,3,1980,1981,1,0.3
DeWayne Scales ,416,36,3,1980,1982,2,-0.1
DeWayne Scales ,416,36,3,1980,1984,4,0
Dexter Pittman ,417,32,4,2010,2011,1,-0.1
Dexter Pittman ,417,32,4,2010,2012,2,0.6
Dexter Pittman ,417,32,4,2010,2013,3,-0.1
Dexter Pittman ,417,32,4,2010,2014,4,0
Dick Miller ,418,40,1,1980,1981,1,-0.1
Dickey Simpkins ,419,21,7,1994,1995,1,0.7
Dickey Simpkins ,419,21,7,1994,1996,2,1.2
Dickey Simpkins ,419,21,7,1994,1997,3,0.1
Dickey Simpkins ,419,21,7,1994,1998,4,0.6
Dickey Simpkins ,419,21,7,1994,1999,5,2.9
Dickey Simpkins ,419,21,7,1994,2000,6,-0.7
Dickey Simpkins ,419,21,7,1994,2002,8,0
Dino Radja ,420,40,4,1989,1994,5,5.9
Dino Radja ,420,40,4,1989,1995,6,4.5
Dino Radja ,420,40,4,1989,1996,7,4
Dino Radja ,420,40,4,1989,1997,8,-0.2
Dion Glover ,421,20,6,1999,2000,1,0.3
Dion Glover ,421,20,6,1999,2001,2,0.8
Dion Glover ,421,20,6,1999,2002,3,0.9
Dion Glover ,421,20,6,1999,2003,4,2.6
Dion Glover ,421,20,6,1999,2004,5,1.1
Dion Glover ,421,20,6,1999,2005,6,0.2
Dion Waiters ,422,4,4,2012,2013,1,0.9
Dion Waiters ,422,4,4,2012,2014,2,1.6
Dion Waiters ,422,4,4,2012,2015,3,1.1
Dion Waiters ,422,4,4,2012,2016,4,2.1
Dirk Minniefield ,423,33,3,1983,1986,3,1.9
Dirk Minniefield ,423,33,3,1983,1987,4,1.1
Dirk Minniefield ,423,33,3,1983,1988,5,1.1
Dirk Nowitzki ,424,9,18,1998,1999,1,0.8
Dirk Nowitzki ,424,9,18,1998,2000,2,8.1
Dirk Nowitzki ,424,9,18,1998,2001,3,14.6
Dirk Nowitzki ,424,9,18,1998,2002,4,13.4
Dirk Nowitzki ,424,9,18,1998,2003,5,16.1
Dirk Nowitzki ,424,9,18,1998,2004,6,11.5
Dirk Nowitzki ,424,9,18,1998,2005,7,15.6
Dirk Nowitzki ,424,9,18,1998,2006,8,17.7
Dirk Nowitzki ,424,9,18,1998,2007,9,16.3
Dirk Nowitzki ,424,9,18,1998,2008,10,12.9
Dirk Nowitzki ,424,9,18,1998,2009,11,10.9
Dirk Nowitzki ,424,9,18,1998,2010,12,12.3
Dirk Nowitzki ,424,9,18,1998,2011,13,11.1
Dirk Nowitzki ,424,9,18,1998,2012,14,7.6
Dirk Nowitzki ,424,9,18,1998,2013,15,5
Dirk Nowitzki ,424,9,18,1998,2014,16,10.9
Dirk Nowitzki ,424,9,18,1998,2015,17,7.2
Dirk Nowitzki ,424,9,18,1998,2016,18,6.8
Doc Rivers ,425,31,13,1983,1984,1,4.2
Doc Rivers ,425,31,13,1983,1985,2,6.3
Doc Rivers ,425,31,13,1983,1986,3,4.2
Doc Rivers ,425,31,13,1983,1987,4,10.3
Doc Rivers ,425,31,13,1983,1988,5,8.3
Doc Rivers ,425,31,13,1983,1989,6,8.5
Doc Rivers ,425,31,13,1983,1990,7,4
Doc Rivers ,425,31,13,1983,1991,8,6.3
Doc Rivers ,425,31,13,1983,1992,9,3.9
Doc Rivers ,425,31,13,1983,1993,10,6.5
Doc Rivers ,425,31,13,1983,1994,11,1.5
Doc Rivers ,425,31,13,1983,1995,12,2
Doc Rivers ,425,31,13,1983,1996,13,2.2
Dominic McGuire ,426,47,6,2007,2008,1,0
Dominic McGuire ,426,47,6,2007,2009,2,1.7
Dominic McGuire ,426,47,6,2007,2010,3,-0.2
Dominic McGuire ,426,47,6,2007,2011,4,0.9
Dominic McGuire ,426,47,6,2007,2012,5,1.5
Dominic McGuire ,426,47,6,2007,2013,6,0.3
Dominique Jones ,427,25,3,2010,2011,1,0
Dominique Jones ,427,25,3,2010,2012,2,0.2
Dominique Jones ,427,25,3,2010,2013,3,0
Don Collins ,428,18,6,1980,1981,1,2.6
Don Collins ,428,18,6,1980,1982,2,3.4
Don Collins ,428,18,6,1980,1983,3,3.5
Don Collins ,428,18,6,1980,1984,4,0.9
Don Collins ,428,18,6,1980,1985,5,0
Don Collins ,428,18,6,1980,1987,7,0
Don MacLean ,429,19,9,1992,1993,1,0.4
Don MacLean ,429,19,9,1992,1994,2,5.6
Don MacLean ,429,19,9,1992,1995,3,1.1
Don MacLean ,429,19,9,1992,1996,4,1.5
Don MacLean ,429,19,9,1992,1997,5,0.5
Don MacLean ,429,19,9,1992,1998,6,-0.2
Don MacLean ,429,19,9,1992,1999,7,0.2
Don MacLean ,429,19,9,1992,2000,8,0
Don MacLean ,429,19,9,1992,2001,9,0.2
Donald Hodge ,430,33,5,1991,1992,1,1.5
Donald Hodge ,430,33,5,1991,1993,2,-0.9
Donald Hodge ,430,33,5,1991,1994,3,0.8
Donald Hodge ,430,33,5,1991,1995,4,0.3
Donald Hodge ,430,33,5,1991,1996,5,0.1
Donatas Motiejunas ,431,20,4,2011,2013,2,0.7
Donatas Motiejunas ,431,20,4,2011,2014,3,1.4
Donatas Motiejunas ,431,20,4,2011,2015,4,4.7
Donatas Motiejunas ,431,20,4,2011,2016,5,0.3
Donnell Harvey ,432,22,5,2000,2001,1,0.1
Donnell Harvey ,432,22,5,2000,2002,2,1.8
Donnell Harvey ,432,22,5,2000,2003,3,2
Donnell Harvey ,432,22,5,2000,2004,4,0.7
Donnell Harvey ,432,22,5,2000,2005,5,0.2
Donnie Boyce ,433,42,2,1995,1996,1,0
Donnie Boyce ,433,42,2,1995,1997,2,-0.3
Donny Marshall ,434,39,5,1995,1996,1,0.2
Donny Marshall ,434,39,5,1995,1997,2,0.6
Donny Marshall ,434,39,5,1995,2000,5,-0.1
Donny Marshall ,434,39,5,1995,2002,7,0.2
Donny Marshall ,434,39,5,1995,2003,8,-0.1
Donta Smith ,435,34,2,2004,2005,1,0.2
Donta Smith ,435,34,2,2004,2006,2,0.3
Dontae' Jones ,436,21,1,1996,1998,2,-0.3
Donte Greene ,437,28,4,2008,2009,1,-1.1
Donte Greene ,437,28,4,2008,2010,2,1.5
Donte Greene ,437,28,4,2008,2011,3,0.5
Donte Greene ,437,28,4,2008,2012,4,0.7
Dontonio Wingfield ,438,37,4,1994,1995,1,0
Dontonio Wingfield ,438,37,4,1994,1996,2,0.9
Dontonio Wingfield ,438,37,4,1994,1997,3,0.9
Dontonio Wingfield ,438,37,4,1994,1998,4,-0.1
Donyell Marshall ,439,4,15,1994,1995,1,0.3
Donyell Marshall ,439,4,15,1994,1996,2,1.3
Donyell Marshall ,439,4,15,1994,1997,3,1.3
Donyell Marshall ,439,4,15,1994,1998,4,4.2
Donyell Marshall ,439,4,15,1994,1999,5,3
Donyell Marshall ,439,4,15,1994,2000,6,3.8
Donyell Marshall ,439,4,15,1994,2001,7,8.5
Donyell Marshall ,439,4,15,1994,2002,8,5
Donyell Marshall ,439,4,15,1994,2003,9,6
Donyell Marshall ,439,4,15,1994,2004,10,10.4
Donyell Marshall ,439,4,15,1994,2005,11,6
Donyell Marshall ,439,4,15,1994,2006,12,4.2
Donyell Marshall ,439,4,15,1994,2007,13,3.8
Donyell Marshall ,439,4,15,1994,2008,14,0.3
Donyell Marshall ,439,4,15,1994,2009,15,0.8
Dorell Wright ,440,19,11,2004,2005,1,-0.1
Dorell Wright ,440,19,11,2004,2006,2,0.2
Dorell Wright ,440,19,11,2004,2007,3,1.9
Dorell Wright ,440,19,11,2004,2008,4,2.2
Dorell Wright ,440,19,11,2004,2009,5,-0.1
Dorell Wright ,440,19,11,2004,2010,6,4.3
Dorell Wright ,440,19,11,2004,2011,7,5.8
Dorell Wright ,440,19,11,2004,2012,8,3.4
Dorell Wright ,440,19,11,2004,2013,9,4.9
Dorell Wright ,440,19,11,2004,2014,10,1.9
Dorell Wright ,440,19,11,2004,2015,11,1.6
Doron Lamb ,441,42,2,2012,2013,1,-0.4
Doron Lamb ,441,42,2,2012,2014,2,0.5
Doug Christie ,442,17,15,1992,1993,1,0.1
Doug Christie ,442,17,15,1992,1994,2,1.4
Doug Christie ,442,17,15,1992,1995,3,-0.3
Doug Christie ,442,17,15,1992,1996,4,1.4
Doug Christie ,442,17,15,1992,1997,5,7
Doug Christie ,442,17,15,1992,1998,6,4
Doug Christie ,442,17,15,1992,1999,7,4.2
Doug Christie ,442,17,15,1992,2000,8,5.1
Doug Christie ,442,17,15,1992,2001,9,8.7
Doug Christie ,442,17,15,1992,2002,10,8.6
Doug Christie ,442,17,15,1992,2003,11,8.9
Doug Christie ,442,17,15,1992,2004,12,5.7
Doug Christie ,442,17,15,1992,2005,13,0.9
Doug Christie ,442,17,15,1992,2006,14,0.1
Doug Christie ,442,17,15,1992,2007,15,-0.1
Doug Edwards ,443,15,3,1993,1994,1,0
Doug Edwards ,443,15,3,1993,1995,2,0.2
Doug Edwards ,443,15,3,1993,1996,3,0.1
Doug Lee ,444,35,3,1987,1992,5,0.4
Doug Lee ,444,35,3,1987,1993,6,0
Doug Lee ,444,35,3,1987,1995,8,0.4
Doug McDermott ,445,11,2,2014,2015,1,0
Doug McDermott ,445,11,2,2014,2016,2,2.8
Doug Overton ,446,40,11,1991,1993,2,0.6
Doug Overton ,446,40,11,1991,1994,3,-0.4
Doug Overton ,446,40,11,1991,1995,4,1.7
Doug Overton ,446,40,11,1991,1996,5,0.2
Doug Overton ,446,40,11,1991,1997,6,0.9
Doug Overton ,446,40,11,1991,1998,7,-0.2
Doug Overton ,446,40,11,1991,1999,8,0.1
Doug Overton ,446,40,11,1991,2000,9,0.4
Doug Overton ,446,40,11,1991,2001,10,-0.3
Doug Overton ,446,40,11,1991,2002,11,-0.2
Doug Overton ,446,40,11,1991,2004,13,-0.3
Doug Roth ,447,41,1,1989,1990,1,0.4
Doug Smith ,448,6,5,1991,1992,1,0.8
Doug Smith ,448,6,5,1991,1993,2,-0.9
Doug Smith ,448,6,5,1991,1994,3,2.3
Doug Smith ,448,6,5,1991,1995,4,1
Doug Smith ,448,6,5,1991,1996,5,-0.2
Doug West ,449,38,12,1989,1990,1,-0.1
Doug West ,449,38,12,1989,1991,2,1.2
Doug West ,449,38,12,1989,1992,3,4.6
Doug West ,449,38,12,1989,1993,4,4.3
Doug West ,449,38,12,1989,1994,5,2.6
Doug West ,449,38,12,1989,1995,6,1.8
Doug West ,449,38,12,1989,1996,7,0.8
Doug West ,449,38,12,1989,1997,8,1.7
Doug West ,449,38,12,1989,1998,9,0.1
Doug West ,449,38,12,1989,1999,10,0.4
Doug West ,449,38,12,1989,2000,11,0.5
Doug West ,449,38,12,1989,2001,12,-0.1
Dragan Tarlac ,450,31,1,1995,2001,6,-0.2
Draymond Green ,451,35,4,2012,2013,1,0.6
Draymond Green ,451,35,4,2012,2014,2,4.5
Draymond Green ,451,35,4,2012,2015,3,8.5
Draymond Green ,451,35,4,2012,2016,4,11.1
Drew Gooden ,452,4,14,2002,2003,1,1.7
Drew Gooden ,452,4,14,2002,2004,2,1.9
Drew Gooden ,452,4,14,2002,2005,3,8.5
Drew Gooden ,452,4,14,2002,2006,4,6.6
Drew Gooden ,452,4,14,2002,2007,5,6.5
Drew Gooden ,452,4,14,2002,2008,6,3.3
Drew Gooden ,452,4,14,2002,2009,7,2.7
Drew Gooden ,452,4,14,2002,2010,8,4.4
Drew Gooden ,452,4,14,2002,2011,9,1.8
Drew Gooden ,452,4,14,2002,2012,10,3.6
Drew Gooden ,452,4,14,2002,2013,11,-0.1
Drew Gooden ,452,4,14,2002,2014,12,1.4
Drew Gooden ,452,4,14,2002,2015,13,1.7
Drew Gooden ,452,4,14,2002,2016,14,0
Duane Causwell ,453,18,11,1990,1991,1,2.8
Duane Causwell ,453,18,11,1990,1992,2,3.9
Duane Causwell ,453,18,11,1990,1993,3,2.9
Duane Causwell ,453,18,11,1990,1994,4,1.2
Duane Causwell ,453,18,11,1990,1995,5,1.8
Duane Causwell ,453,18,11,1990,1996,6,1.3
Duane Causwell ,453,18,11,1990,1997,7,0.7
Duane Causwell ,453,18,11,1990,1998,8,0.5
Duane Causwell ,453,18,11,1990,1999,9,0
Duane Causwell ,453,18,11,1990,2000,10,0.7
Duane Causwell ,453,18,11,1990,2001,11,0
Duane Cooper ,454,36,2,1992,1993,1,-0.4
Duane Cooper ,454,36,2,1992,1994,2,-0.1
Duane Washington ,455,36,2,1987,1988,1,0.4
Duane Washington ,455,36,2,1987,1993,6,-0.1
Dudley Bradley ,456,13,9,1979,1980,1,3.1
Dudley Bradley ,456,13,9,1979,1981,2,3.9
Dudley Bradley ,456,13,9,1979,1982,3,1.4
Dudley Bradley ,456,13,9,1979,1983,4,1.1
Dudley Bradley ,456,13,9,1979,1985,6,2.4
Dudley Bradley ,456,13,9,1979,1986,7,1
Dudley Bradley ,456,13,9,1979,1987,8,1.7
Dudley Bradley ,456,13,9,1979,1988,9,1.9
Dudley Bradley ,456,13,9,1979,1989,10,0
Dwayne McClain ,457,27,1,1985,1986,1,-0.3
Dwayne Morton ,458,45,1,1994,1995,1,0.2
Dwayne Schintzius ,459,24,8,1990,1991,1,0.2
Dwayne Schintzius ,459,24,8,1990,1992,2,0.4
Dwayne Schintzius ,459,24,8,1990,1993,3,0.1
Dwayne Schintzius ,459,24,8,1990,1994,4,0.2
Dwayne Schintzius ,459,24,8,1990,1995,5,-0.1
Dwayne Schintzius ,459,24,8,1990,1996,6,0.3
Dwayne Schintzius ,459,24,8,1990,1997,7,0
Dwayne Schintzius ,459,24,8,1990,1999,9,-0.2
Dwayne Whitfield ,460,40,1,1995,1996,1,0
Dwight Anderson ,461,41,1,1982,1983,1,0
Dwight Howard ,462,1,12,2004,2005,1,7.3
Dwight Howard ,462,1,12,2004,2006,2,8.6
Dwight Howard ,462,1,12,2004,2007,3,9.7
Dwight Howard ,462,1,12,2004,2008,4,12.9
Dwight Howard ,462,1,12,2004,2009,5,13.8
Dwight Howard ,462,1,12,2004,2010,6,13.2
Dwight Howard ,462,1,12,2004,2011,7,14.4
Dwight Howard ,462,1,12,2004,2012,8,7.7
Dwight Howard ,462,1,12,2004,2013,9,7.6
Dwight Howard ,462,1,12,2004,2014,10,8
Dwight Howard ,462,1,12,2004,2015,11,3.6
Dwight Howard ,462,1,12,2004,2016,12,6.6
Dwight Powell ,463,45,2,2014,2015,1,0.6
Dwight Powell ,463,45,2,2014,2016,2,3.1
Dwyane Wade ,464,5,13,2003,2004,1,4.6
Dwyane Wade ,464,5,13,2003,2005,2,11
Dwyane Wade ,464,5,13,2003,2006,3,14.4
Dwyane Wade ,464,5,13,2003,2007,4,8.8
Dwyane Wade ,464,5,13,2003,2008,5,3.3
Dwyane Wade ,464,5,13,2003,2009,6,14.7
Dwyane Wade ,464,5,13,2003,2010,7,13
Dwyane Wade ,464,5,13,2003,2011,8,12.8
Dwyane Wade ,464,5,13,2003,2012,9,7.7
Dwyane Wade ,464,5,13,2003,2013,10,9.6
Dwyane Wade ,464,5,13,2003,2014,11,5.5
Dwyane Wade ,464,5,13,2003,2015,12,3.5
Dwyane Wade ,464,5,13,2003,2016,13,4.9
Dyron Nix ,465,29,1,1989,1990,1,0
Earl Clark ,466,14,6,2009,2010,1,-0.3
Earl Clark ,466,14,6,2009,2011,2,0.3
Earl Clark ,466,14,6,2009,2012,3,0.3
Earl Clark ,466,14,6,2009,2013,4,2.3
Earl Clark ,466,14,6,2009,2014,5,0.3
Earl Clark ,466,14,6,2009,2015,6,-0.1
Earl Jones ,467,23,2,1984,1985,1,0
Earl Jones ,467,23,2,1984,1986,2,0
Earl Watson ,468,39,13,2001,2002,1,1.5
Earl Watson ,468,39,13,2001,2003,2,2.3
Earl Watson ,468,39,13,2001,2004,3,1.8
Earl Watson ,468,39,13,2001,2005,4,2.3
Earl Watson ,468,39,13,2001,2006,5,2.7
Earl Watson ,468,39,13,2001,2007,6,2
Earl Watson ,468,39,13,2001,2008,7,2.9
Earl Watson ,468,39,13,2001,2009,8,-0.2
Earl Watson ,468,39,13,2001,2010,9,2.6
Earl Watson ,468,39,13,2001,2011,10,1
Earl Watson ,468,39,13,2001,2012,11,0.4
Earl Watson ,468,39,13,2001,2013,12,0
Earl Watson ,468,39,13,2001,2014,13,-0.1
Ed Davis ,469,13,6,2010,2011,1,4
Ed Davis ,469,13,6,2010,2012,2,3.9
Ed Davis ,469,13,6,2010,2013,3,5.4
Ed Davis ,469,13,6,2010,2014,4,2.6
Ed Davis ,469,13,6,2010,2015,5,6.3
Ed Davis ,469,13,6,2010,2016,6,6.7
Ed Gray ,470,22,2,1997,1998,1,0.8
Ed Gray ,470,22,2,1997,1999,2,-0.7
Ed Horton ,471,39,1,1989,1990,1,0.4
Ed O'Bannon ,472,9,2,1995,1996,1,0.7
Ed O'Bannon ,472,9,2,1995,1997,2,0.4
Ed Pinckney ,473,10,12,1985,1986,1,2.7
Ed Pinckney ,473,10,12,1985,1987,2,6.2
Ed Pinckney ,473,10,12,1985,1988,3,2.3
Ed Pinckney ,473,10,12,1985,1989,4,6.1
Ed Pinckney ,473,10,12,1985,1990,5,2.9
Ed Pinckney ,473,10,12,1985,1991,6,4.7
Ed Pinckney ,473,10,12,1985,1992,7,7.5
Ed Pinckney ,473,10,12,1985,1993,8,0.3
Ed Pinckney ,473,10,12,1985,1994,9,4
Ed Pinckney ,473,10,12,1985,1995,10,1.6
Ed Pinckney ,473,10,12,1985,1996,11,3.7
Ed Pinckney ,473,10,12,1985,1997,12,0.7
Ed Rains ,474,30,2,1981,1982,1,0.6
Ed Rains ,474,30,2,1981,1983,2,0.1
Ed Stokes ,475,35,1,1993,1998,5,0
Eddie Griffin ,476,7,5,2001,2002,1,2.4
Eddie Griffin ,476,7,5,2001,2003,2,3.9
Eddie Griffin ,476,7,5,2001,2005,4,3.2
Eddie Griffin ,476,7,5,2001,2006,5,1.5
Eddie Griffin ,476,7,5,2001,2007,6,-0.2
Eddie House ,477,37,11,2000,2001,1,0.4
Eddie House ,477,37,11,2000,2002,2,0.9
Eddie House ,477,37,11,2000,2003,3,0.7
Eddie House ,477,37,11,2000,2004,4,0.7
Eddie House ,477,37,11,2000,2005,5,1.8
Eddie House ,477,37,11,2000,2006,6,1.6
Eddie House ,477,37,11,2000,2007,7,1.9
Eddie House ,477,37,11,2000,2008,8,3.9
Eddie House ,477,37,11,2000,2009,9,4.9
Eddie House ,477,37,11,2000,2010,10,1.1
Eddie House ,477,37,11,2000,2011,11,2.2
Eddie Johnson ,478,29,17,1981,1982,1,1.8
Eddie Johnson ,478,29,17,1981,1983,2,7.4
Eddie Johnson ,478,29,17,1981,1984,3,5.6
Eddie Johnson ,478,29,17,1981,1985,4,5.3
Eddie Johnson ,478,29,17,1981,1986,5,4
Eddie Johnson ,478,29,17,1981,1987,6,4.3
Eddie Johnson ,478,29,17,1981,1988,7,3
Eddie Johnson ,478,29,17,1981,1989,8,6.5
Eddie Johnson ,478,29,17,1981,1990,9,3.9
Eddie Johnson ,478,29,17,1981,1991,10,5.5
Eddie Johnson ,478,29,17,1981,1992,11,5.6
Eddie Johnson ,478,29,17,1981,1993,12,4.8
Eddie Johnson ,478,29,17,1981,1994,13,2.4
Eddie Johnson ,478,29,17,1981,1995,14,1.6
Eddie Johnson ,478,29,17,1981,1996,15,1.8
Eddie Johnson ,478,29,17,1981,1997,16,2.2
Eddie Johnson ,478,29,17,1981,1998,17,-0.1
Eddie Johnson D,479,49,10,1977,1978,1,3.5
Eddie Johnson D,479,49,10,1977,1979,2,6.3
Eddie Johnson D,479,49,10,1977,1980,3,8.2
Eddie Johnson D,479,49,10,1977,1981,4,6.9
Eddie Johnson D,479,49,10,1977,1982,5,4.8
Eddie Johnson D,479,49,10,1977,1983,6,3
Eddie Johnson D,479,49,10,1977,1984,7,1.7
Eddie Johnson D,479,49,10,1977,1985,8,4.2
Eddie Johnson D,479,49,10,1977,1986,9,1.5
Eddie Johnson D,479,49,10,1977,1987,10,0.8
Eddie Jones ,480,10,14,1994,1995,1,5
Eddie Jones ,480,10,14,1994,1996,2,6.8
Eddie Jones ,480,10,14,1994,1997,3,9.6
Eddie Jones ,480,10,14,1994,1998,4,10.1
Eddie Jones ,480,10,14,1994,1999,5,6
Eddie Jones ,480,10,14,1994,2000,6,10.1
Eddie Jones ,480,10,14,1994,2001,7,7.9
Eddie Jones ,480,10,14,1994,2002,8,10.5
Eddie Jones ,480,10,14,1994,2003,9,6
Eddie Jones ,480,10,14,1994,2004,10,9.1
Eddie Jones ,480,10,14,1994,2005,11,8
Eddie Jones ,480,10,14,1994,2006,12,7.2
Eddie Jones ,480,10,14,1994,2007,13,3.1
Eddie Jones ,480,10,14,1994,2008,14,1.1
Eddie Phillips ,481,21,1,1982,1983,1,0.1
Eddy Curry ,482,4,11,2001,2002,1,1.8
Eddy Curry ,482,4,11,2001,2003,2,3.5
Eddy Curry ,482,4,11,2001,2004,3,3
Eddy Curry ,482,4,11,2001,2005,4,4.3
Eddy Curry ,482,4,11,2001,2006,5,3.3
Eddy Curry ,482,4,11,2001,2007,6,4.7
Eddy Curry ,482,4,11,2001,2008,7,1.7
Eddy Curry ,482,4,11,2001,2009,8,0
Eddy Curry ,482,4,11,2001,2010,9,-0.3
Eddy Curry ,482,4,11,2001,2012,11,-0.1
Eddy Curry ,482,4,11,2001,2013,12,-0.1
Edgar Jones ,483,31,6,1979,1981,2,2.3
Edgar Jones ,483,31,6,1979,1982,3,2.4
Edgar Jones ,483,31,6,1979,1983,4,3.4
Edgar Jones ,483,31,6,1979,1984,5,3.4
Edgar Jones ,483,31,6,1979,1985,6,0.9
Edgar Jones ,483,31,6,1979,1986,7,2.6
Eduardo Najera ,484,38,12,2000,2001,1,1.1
Eduardo Najera ,484,38,12,2000,2002,2,4
Eduardo Najera ,484,38,12,2000,2003,3,4
Eduardo Najera ,484,38,12,2000,2004,4,1.1
Eduardo Najera ,484,38,12,2000,2005,5,1.6
Eduardo Najera ,484,38,12,2000,2006,6,2.7
Eduardo Najera ,484,38,12,2000,2007,7,4.8
Eduardo Najera ,484,38,12,2000,2008,8,4.1
Eduardo Najera ,484,38,12,2000,2009,9,0.1
Eduardo Najera ,484,38,12,2000,2010,10,0.8
Eduardo Najera ,484,38,12,2000,2011,11,0.2
Eduardo Najera ,484,38,12,2000,2012,12,0.2
Efthimi Rentzias ,485,23,1,1996,2003,7,0.2
Ekpe Udoh ,486,6,5,2010,2011,1,0.7
Ekpe Udoh ,486,6,5,2010,2012,2,2.1
Ekpe Udoh ,486,6,5,2010,2013,3,2.7
Ekpe Udoh ,486,6,5,2010,2014,4,0
Ekpe Udoh ,486,6,5,2010,2015,5,0.3
Elden Campbell ,487,27,15,1990,1991,1,1.1
Elden Campbell ,487,27,15,1990,1992,2,3.3
Elden Campbell ,487,27,15,1990,1993,3,2.6
Elden Campbell ,487,27,15,1990,1994,4,4.2
Elden Campbell ,487,27,15,1990,1995,5,3.8
Elden Campbell ,487,27,15,1990,1996,6,8.2
Elden Campbell ,487,27,15,1990,1997,7,7
Elden Campbell ,487,27,15,1990,1998,8,4.7
Elden Campbell ,487,27,15,1990,1999,9,4.3
Elden Campbell ,487,27,15,1990,2000,10,5.5
Elden Campbell ,487,27,15,1990,2001,11,6.4
Elden Campbell ,487,27,15,1990,2002,12,7.6
Elden Campbell ,487,27,15,1990,2003,13,2
Elden Campbell ,487,27,15,1990,2004,14,2.1
Elden Campbell ,487,27,15,1990,2005,15,0
Elfrid Payton ,488,10,2,2014,2015,1,2.3
Elfrid Payton ,488,10,2,2014,2016,2,2.2
Elliot Perry ,489,37,10,1991,1992,1,-0.4
Elliot Perry ,489,37,10,1991,1994,3,0.3
Elliot Perry ,489,37,10,1991,1995,4,5.2
Elliot Perry ,489,37,10,1991,1996,5,3.1
Elliot Perry ,489,37,10,1991,1997,6,3.2
Elliot Perry ,489,37,10,1991,1998,7,1.3
Elliot Perry ,489,37,10,1991,1999,8,-0.1
Elliot Perry ,489,37,10,1991,2000,9,0.9
Elliot Perry ,489,37,10,1991,2001,10,0.6
Elliot Perry ,489,37,10,1991,2002,11,-0.1
Elliot Williams ,490,22,4,2010,2012,2,0.3
Elliot Williams ,490,22,4,2010,2014,4,0.3
Elliot Williams ,490,22,4,2010,2015,5,0.1
Elliot Williams ,490,22,4,2010,2016,6,0
Elmer Bennett ,491,38,3,1992,1995,3,0.1
Elmer Bennett ,491,38,3,1992,1996,4,-0.3
Elmer Bennett ,491,38,3,1992,1997,5,-0.1
Elmore Spencer ,492,25,5,1992,1993,1,0.2
Elmore Spencer ,492,25,5,1992,1994,2,0.6
Elmore Spencer ,492,25,5,1992,1995,3,-0.7
Elmore Spencer ,492,25,5,1992,1996,4,-0.1
Elmore Spencer ,492,25,5,1992,1997,5,0
Elston Turner ,493,43,8,1981,1982,1,1.4
Elston Turner ,493,43,8,1981,1983,2,0.1
Elston Turner ,493,43,8,1981,1984,3,0.3
Elston Turner ,493,43,8,1981,1985,4,2.3
Elston Turner ,493,43,8,1981,1986,5,1.3
Elston Turner ,493,43,8,1981,1987,6,1.2
Elston Turner ,493,43,8,1981,1988,7,-0.2
Elston Turner ,493,43,8,1981,1989,8,2.1
Elton Brand ,494,1,17,1999,2000,1,7.5
Elton Brand ,494,1,17,1999,2001,2,6.1
Elton Brand ,494,1,17,1999,2002,3,13.6
Elton Brand ,494,1,17,1999,2003,4,7.6
Elton Brand ,494,1,17,1999,2004,5,9.7
Elton Brand ,494,1,17,1999,2005,6,10.6
Elton Brand ,494,1,17,1999,2006,7,14.8
Elton Brand ,494,1,17,1999,2007,8,11.5
Elton Brand ,494,1,17,1999,2008,9,0.5
Elton Brand ,494,1,17,1999,2009,10,0.9
Elton Brand ,494,1,17,1999,2010,11,3.5
Elton Brand ,494,1,17,1999,2011,12,9.4
Elton Brand ,494,1,17,1999,2012,13,6.1
Elton Brand ,494,1,17,1999,2013,14,3.4
Elton Brand ,494,1,17,1999,2014,15,3.6
Elton Brand ,494,1,17,1999,2015,16,0.7
Elton Brand ,494,1,17,1999,2016,17,0.2
Emeka Okafor ,495,2,9,2004,2005,1,4
Emeka Okafor ,495,2,9,2004,2006,2,1
Emeka Okafor ,495,2,9,2004,2007,3,7.1
Emeka Okafor ,495,2,9,2004,2008,4,5.8
Emeka Okafor ,495,2,9,2004,2009,5,8.2
Emeka Okafor ,495,2,9,2004,2010,6,5.5
Emeka Okafor ,495,2,9,2004,2011,7,6.5
Emeka Okafor ,495,2,9,2004,2012,8,1.7
Emeka Okafor ,495,2,9,2004,2013,9,4.5
Emmanuel Mudiay ,496,7,1,2015,2016,1,-2.1
Enes Kanter ,497,3,5,2011,2012,1,1.7
Enes Kanter ,497,3,5,2011,2013,2,2.3
Enes Kanter ,497,3,5,2011,2014,3,2.2
Enes Kanter ,497,3,5,2011,2015,4,6.4
Enes Kanter ,497,3,5,2011,2016,5,8.1
Ennis Whatley ,498,13,10,1983,1984,1,1.9
Ennis Whatley ,498,13,10,1983,1985,2,0.8
Ennis Whatley ,498,13,10,1983,1986,3,0
Ennis Whatley ,498,13,10,1983,1987,4,3.3
Ennis Whatley ,498,13,10,1983,1988,5,0
Ennis Whatley ,498,13,10,1983,1989,6,0
Ennis Whatley ,498,13,10,1983,1992,9,0.6
Ennis Whatley ,498,13,10,1983,1994,11,2.2
Ennis Whatley ,498,13,10,1983,1995,12,0.7
Ennis Whatley ,498,13,10,1983,1997,14,0
Eric Bledsoe ,499,18,6,2010,2011,1,0.3
Eric Bledsoe ,499,18,6,2010,2012,2,0.2
Eric Bledsoe ,499,18,6,2010,2013,3,3.7
Eric Bledsoe ,499,18,6,2010,2014,4,4.1
Eric Bledsoe ,499,18,6,2010,2015,5,7
Eric Bledsoe ,499,18,6,2010,2016,6,2.5
Eric Gordon ,500,7,8,2008,2009,1,4.6
Eric Gordon ,500,7,8,2008,2010,2,3.2
Eric Gordon ,500,7,8,2008,2011,3,5.3
Eric Gordon ,500,7,8,2008,2012,4,0.7
Eric Gordon ,500,7,8,2008,2013,5,1.1
Eric Gordon ,500,7,8,2008,2014,6,2.5
Eric Gordon ,500,7,8,2008,2015,7,2.9
Eric Gordon ,500,7,8,2008,2016,8,2.1
Eric Leckner ,501,17,8,1988,1989,1,1.5
Eric Leckner ,501,17,8,1988,1990,2,1.7
Eric Leckner ,501,17,8,1988,1991,3,0.2
Eric Leckner ,501,17,8,1988,1992,4,0.9
Eric Leckner ,501,17,8,1988,1994,6,0.9
Eric Leckner ,501,17,8,1988,1995,7,0.9
Eric Leckner ,501,17,8,1988,1996,8,0.2
Eric Leckner ,501,17,8,1988,1997,9,-0.1
Eric Maynor ,502,20,5,2009,2010,1,1.9
Eric Maynor ,502,20,5,2009,2011,2,1.5
Eric Maynor ,502,20,5,2009,2012,3,0.1
Eric Maynor ,502,20,5,2009,2013,4,0.2
Eric Maynor ,502,20,5,2009,2014,5,-0.4
Eric Mobley ,503,18,3,1994,1995,1,1.3
Eric Mobley ,503,18,3,1994,1996,2,0.2
Eric Mobley ,503,18,3,1994,1997,3,-0.4
Eric Montross ,504,9,8,1994,1995,1,4.1
Eric Montross ,504,9,8,1994,1996,2,1.3
Eric Montross ,504,9,8,1994,1997,3,1.4
Eric Montross ,504,9,8,1994,1998,4,0.7
Eric Montross ,504,9,8,1994,1999,5,1.3
Eric Montross ,504,9,8,1994,2000,6,-0.4
Eric Montross ,504,9,8,1994,2001,7,0
Eric Montross ,504,9,8,1994,2002,8,0.2
Eric Murdock ,505,21,9,1991,1992,1,0.6
Eric Murdock ,505,21,9,1991,1993,2,6.1
Eric Murdock ,505,21,9,1991,1994,3,7.2
Eric Murdock ,505,21,9,1991,1995,4,4.3
Eric Murdock ,505,21,9,1991,1996,5,2.5
Eric Murdock ,505,21,9,1991,1997,6,0.3
Eric Murdock ,505,21,9,1991,1998,7,4.1
Eric Murdock ,505,21,9,1991,1999,8,0.4
Eric Murdock ,505,21,9,1991,2000,9,0.1
Eric Piatkowski ,506,15,14,1994,1995,1,2
Eric Piatkowski ,506,15,14,1994,1996,2,1.2
Eric Piatkowski ,506,15,14,1994,1997,3,2.3
Eric Piatkowski ,506,15,14,1994,1998,4,3.9
Eric Piatkowski ,506,15,14,1994,1999,5,2.3
Eric Piatkowski ,506,15,14,1994,2000,6,2.3
Eric Piatkowski ,506,15,14,1994,2001,7,5.5
Eric Piatkowski ,506,15,14,1994,2002,8,4.5
Eric Piatkowski ,506,15,14,1994,2003,9,3.6
Eric Piatkowski ,506,15,14,1994,2004,10,0.9
Eric Piatkowski ,506,15,14,1994,2005,11,2.3
Eric Piatkowski ,506,15,14,1994,2006,12,0.1
Eric Piatkowski ,506,15,14,1994,2007,13,0
Eric Piatkowski ,506,15,14,1994,2008,14,0.1
Eric Riley ,507,33,5,1993,1994,1,0.4
Eric Riley ,507,33,5,1993,1995,2,0.6
Eric Riley ,507,33,5,1993,1996,3,0.5
Eric Riley ,507,33,5,1993,1998,5,0.3
Eric Riley ,507,33,5,1993,1999,6,0.7
Eric Snow ,508,43,13,1995,1996,1,0.5
Eric Snow ,508,43,13,1995,1997,2,1.9
Eric Snow ,508,43,13,1995,1998,3,1.3
Eric Snow ,508,43,13,1995,1999,4,3.8
Eric Snow ,508,43,13,1995,2000,5,6.1
Eric Snow ,508,43,13,1995,2001,6,3.8
Eric Snow ,508,43,13,1995,2002,7,5.5
Eric Snow ,508,43,13,1995,2003,8,8.4
Eric Snow ,508,43,13,1995,2004,9,5.5
Eric Snow ,508,43,13,1995,2005,10,1.9
Eric Snow ,508,43,13,1995,2006,11,2.1
Eric Snow ,508,43,13,1995,2007,12,2.8
Eric Snow ,508,43,13,1995,2008,13,-0.1
Eric Washington ,509,46,2,1997,1998,1,-0.3
Eric Washington ,509,46,2,1997,1999,2,0.3
Eric Williams ,510,14,12,1995,1996,1,1.6
Eric Williams ,510,14,12,1995,1997,2,2.9
Eric Williams ,510,14,12,1995,1998,3,0.1
Eric Williams ,510,14,12,1995,1999,4,0.2
Eric Williams ,510,14,12,1995,2000,5,2.5
Eric Williams ,510,14,12,1995,2001,6,2.2
Eric Williams ,510,14,12,1995,2002,7,2.2
Eric Williams ,510,14,12,1995,2003,8,6
Eric Williams ,510,14,12,1995,2004,9,3.1
Eric Williams ,510,14,12,1995,2005,10,2.1
Eric Williams ,510,14,12,1995,2006,11,0.1
Eric Williams ,510,14,12,1995,2007,12,0.1
Erick Barkley ,511,28,2,2000,2001,1,-0.1
Erick Barkley ,511,28,2,2000,2002,2,0.2
Erick Dampier ,512,10,16,1996,1997,1,0.9
Erick Dampier ,512,10,16,1996,1998,2,4
Erick Dampier ,512,10,16,1996,1999,3,1.5
Erick Dampier ,512,10,16,1996,2000,4,-0.1
Erick Dampier ,512,10,16,1996,2001,5,-0.5
Erick Dampier ,512,10,16,1996,2002,6,0.3
Erick Dampier ,512,10,16,1996,2003,7,4.1
Erick Dampier ,512,10,16,1996,2004,8,8.9
Erick Dampier ,512,10,16,1996,2005,9,4.5
Erick Dampier ,512,10,16,1996,2006,10,4.8
Erick Dampier ,512,10,16,1996,2007,11,6.4
Erick Dampier ,512,10,16,1996,2008,12,6
Erick Dampier ,512,10,16,1996,2009,13,6.1
Erick Dampier ,512,10,16,1996,2010,14,3.7
Erick Dampier ,512,10,16,1996,2011,15,1.9
Erick Dampier ,512,10,16,1996,2012,16,0.1
Erick Green ,513,46,2,2013,2015,2,0
Erick Green ,513,46,2,2013,2016,3,0.1
Erik Murphy ,514,49,1,2013,2014,1,-0.1
Ersan Ilyasova ,515,36,8,2005,2007,2,1
Ersan Ilyasova ,515,36,8,2005,2010,5,5.8
Ersan Ilyasova ,515,36,8,2005,2011,6,3.8
Ersan Ilyasova ,515,36,8,2005,2012,7,6.4
Ersan Ilyasova ,515,36,8,2005,2013,8,6.7
Ersan Ilyasova ,515,36,8,2005,2014,9,1.6
Ersan Ilyasova ,515,36,8,2005,2015,10,4
Ersan Ilyasova ,515,36,8,2005,2016,11,4.4
Ervin Johnson ,516,23,13,1993,1994,1,0.7
Ervin Johnson ,516,23,13,1993,1995,2,1.3
Ervin Johnson ,516,23,13,1993,1996,3,3.9
Ervin Johnson ,516,23,13,1993,1997,4,5.2
Ervin Johnson ,516,23,13,1993,1998,5,6.4
Ervin Johnson ,516,23,13,1993,1999,6,3
Ervin Johnson ,516,23,13,1993,2000,7,4.9
Ervin Johnson ,516,23,13,1993,2001,8,5.1
Ervin Johnson ,516,23,13,1993,2002,9,2.3
Ervin Johnson ,516,23,13,1993,2003,10,1.9
Ervin Johnson ,516,23,13,1993,2004,11,2.3
Ervin Johnson ,516,23,13,1993,2005,12,0.8
Ervin Johnson ,516,23,13,1993,2006,13,0
Etan Thomas ,517,12,9,2000,2002,2,1.6
Etan Thomas ,517,12,9,2000,2003,3,1.3
Etan Thomas ,517,12,9,2000,2004,4,4.5
Etan Thomas ,517,12,9,2000,2005,5,1.6
Etan Thomas ,517,12,9,2000,2006,6,2.5
Etan Thomas ,517,12,9,2000,2007,7,2.7
Etan Thomas ,517,12,9,2000,2009,9,0.1
Etan Thomas ,517,12,9,2000,2010,10,0.2
Etan Thomas ,517,12,9,2000,2011,11,0.2
Evan Eschmeyer ,518,34,4,1999,2000,1,0.7
Evan Eschmeyer ,518,34,4,1999,2001,2,2.5
Evan Eschmeyer ,518,34,4,1999,2002,3,0.5
Evan Eschmeyer ,518,34,4,1999,2003,4,0.2
Evan Fournier ,519,20,4,2012,2013,1,1
Evan Fournier ,519,20,4,2012,2014,2,1.4
Evan Fournier ,519,20,4,2012,2015,3,2.1
Evan Fournier ,519,20,4,2012,2016,4,5.7
Evan Turner ,520,2,6,2010,2011,1,2.3
Evan Turner ,520,2,6,2010,2012,2,2.4
Evan Turner ,520,2,6,2010,2013,3,2.1
Evan Turner ,520,2,6,2010,2014,4,1.4
Evan Turner ,520,2,6,2010,2015,5,2.5
Evan Turner ,520,2,6,2010,2016,6,4
Everette Stephens ,521,31,2,1988,1989,1,-0.4
Everette Stephens ,521,31,2,1988,1991,3,0.1
Evers Burns ,522,31,1,1993,1994,1,0.1
Fab Melo ,523,22,1,2012,2013,1,0
Fat Lever ,524,11,11,1982,1983,1,4.4
Fat Lever ,524,11,11,1982,1984,2,4.8
Fat Lever ,524,11,11,1982,1985,3,5.2
Fat Lever ,524,11,11,1982,1986,4,4.5
Fat Lever ,524,11,11,1982,1987,5,9.7
Fat Lever ,524,11,11,1982,1988,6,10.4
Fat Lever ,524,11,11,1982,1989,7,9.2
Fat Lever ,524,11,11,1982,1990,8,8.8
Fat Lever ,524,11,11,1982,1991,9,0
Fat Lever ,524,11,11,1982,1992,10,1.3
Fat Lever ,524,11,11,1982,1994,12,2.9
Felipe Lopez ,525,24,4,1998,1999,1,0.5
Felipe Lopez ,525,24,4,1998,2000,2,0.4
Felipe Lopez ,525,24,4,1998,2001,3,1.9
Felipe Lopez ,525,24,4,1998,2002,4,0.3
Felton Spencer ,526,6,12,1990,1991,1,5.6
Felton Spencer ,526,6,12,1990,1992,2,2
Felton Spencer ,526,6,12,1990,1993,3,1.1
Felton Spencer ,526,6,12,1990,1994,4,4.7
Felton Spencer ,526,6,12,1990,1995,5,2
Felton Spencer ,526,6,12,1990,1996,6,2.4
Felton Spencer ,526,6,12,1990,1997,7,1.3
Felton Spencer ,526,6,12,1990,1998,8,0.9
Felton Spencer ,526,6,12,1990,1999,9,0.3
Felton Spencer ,526,6,12,1990,2000,10,0.5
Felton Spencer ,526,6,12,1990,2001,11,0.4
Felton Spencer ,526,6,12,1990,2002,12,-0.1
Fennis Dembo ,527,30,1,1988,1989,1,-0.1
Fernando Martin ,528,38,1,1985,1987,2,-0.4
Festus Ezeli ,529,30,3,2012,2013,1,1.5
Festus Ezeli ,529,30,3,2012,2015,3,1.7
Festus Ezeli ,529,30,3,2012,2016,4,2.7
Forrest McKenzie ,530,48,1,1986,1987,1,-0.2
Francisco Elson ,531,41,9,1999,2004,5,1.8
Francisco Elson ,531,41,9,1999,2005,6,1.6
Francisco Elson ,531,41,9,1999,2006,7,2.9
Francisco Elson ,531,41,9,1999,2007,8,3.1
Francisco Elson ,531,41,9,1999,2008,9,0
Francisco Elson ,531,41,9,1999,2009,10,1.8
Francisco Elson ,531,41,9,1999,2010,11,0
Francisco Elson ,531,41,9,1999,2011,12,0.6
Francisco Elson ,531,41,9,1999,2012,13,0
Francisco Garcia ,532,23,10,2005,2006,1,1.6
Francisco Garcia ,532,23,10,2005,2007,2,2.4
Francisco Garcia ,532,23,10,2005,2008,3,4.2
Francisco Garcia ,532,23,10,2005,2009,4,2.4
Francisco Garcia ,532,23,10,2005,2010,5,1
Francisco Garcia ,532,23,10,2005,2011,6,3
Francisco Garcia ,532,23,10,2005,2012,7,0.8
Francisco Garcia ,532,23,10,2005,2013,8,1.3
Francisco Garcia ,532,23,10,2005,2014,9,1.8
Francisco Garcia ,532,23,10,2005,2015,10,-0.2
Frank Johnson ,533,11,10,1981,1982,1,2.1
Frank Johnson ,533,11,10,1981,1983,2,3
Frank Johnson ,533,11,10,1981,1984,3,4.3
Frank Johnson ,533,11,10,1981,1985,4,1.9
Frank Johnson ,533,11,10,1981,1986,5,0.5
Frank Johnson ,533,11,10,1981,1987,6,0.5
Frank Johnson ,533,11,10,1981,1988,7,1.6
Frank Johnson ,533,11,10,1981,1989,8,0.6
Frank Johnson ,533,11,10,1981,1993,12,1.5
Frank Johnson ,533,11,10,1981,1994,13,1.2
Frank Kaminsky ,534,9,1,2015,2016,1,3.3
Frank Kornet ,535,30,2,1989,1990,1,0
Frank Kornet ,535,30,2,1989,1991,2,-0.1
Frank Williams ,536,25,3,2002,2003,1,-0.1
Frank Williams ,536,25,3,2002,2004,2,0.3
Frank Williams ,536,25,3,2002,2005,3,-0.2
Frankie King ,537,37,2,1995,1996,1,-0.1
Frankie King ,537,37,2,1995,1997,2,0.1
Frankie Sanders ,538,20,2,1978,1979,1,0.4
Frankie Sanders ,538,20,2,1978,1981,3,0.1
Franklin Edwards ,539,22,7,1981,1982,1,0.2
Franklin Edwards ,539,22,7,1981,1983,2,2.7
Franklin Edwards ,539,22,7,1981,1984,3,0.1
Franklin Edwards ,539,22,7,1981,1985,4,0.6
Franklin Edwards ,539,22,7,1981,1986,5,0.8
Franklin Edwards ,539,22,7,1981,1987,6,-0.3
Franklin Edwards ,539,22,7,1981,1988,7,-0.2
Fred Jones ,540,14,7,2002,2003,1,0
Fred Jones ,540,14,7,2002,2004,2,4
Fred Jones ,540,14,7,2002,2005,3,4.8
Fred Jones ,540,14,7,2002,2006,4,2.6
Fred Jones ,540,14,7,2002,2007,5,1.2
Fred Jones ,540,14,7,2002,2008,6,2.2
Fred Jones ,540,14,7,2002,2009,7,1.6
Fred Roberts ,541,27,13,1982,1984,2,3
Fred Roberts ,541,27,13,1982,1985,3,2.6
Fred Roberts ,541,27,13,1982,1986,4,0.2
Fred Roberts ,541,27,13,1982,1987,5,1.8
Fred Roberts ,541,27,13,1982,1988,6,1.9
Fred Roberts ,541,27,13,1982,1989,7,2
Fred Roberts ,541,27,13,1982,1990,8,3.5
Fred Roberts ,541,27,13,1982,1991,9,4.2
Fred Roberts ,541,27,13,1982,1992,10,2.2
Fred Roberts ,541,27,13,1982,1993,11,3.9
Fred Roberts ,541,27,13,1982,1995,13,0.4
Fred Roberts ,541,27,13,1982,1996,14,0.6
Fred Roberts ,541,27,13,1982,1997,15,0
Freeman Williams ,542,8,6,1978,1979,1,1.8
Freeman Williams ,542,8,6,1978,1980,2,4.1
Freeman Williams ,542,8,6,1978,1981,3,4
Freeman Williams ,542,8,6,1978,1982,4,0.4
Freeman Williams ,542,8,6,1978,1983,5,-0.2
Freeman Williams ,542,8,6,1978,1986,8,-0.1
Gabe Pruitt ,543,32,2,2007,2008,1,0.1
Gabe Pruitt ,543,32,2,2007,2009,2,0.4
Gani Lawal ,544,46,1,2010,2011,1,0
Gary Garland ,545,30,1,1979,1980,1,0.5
Gary Grant ,546,15,13,1988,1989,1,-0.4
Gary Grant ,546,15,13,1988,1990,2,1.3
Gary Grant ,546,15,13,1988,1991,3,1.7
Gary Grant ,546,15,13,1988,1992,4,3
Gary Grant ,546,15,13,1988,1993,5,1.6
Gary Grant ,546,15,13,1988,1994,6,1.3
Gary Grant ,546,15,13,1988,1995,7,0.6
Gary Grant ,546,15,13,1988,1996,8,1.4
Gary Grant ,546,15,13,1988,1997,9,0.4
Gary Grant ,546,15,13,1988,1998,10,1.1
Gary Grant ,546,15,13,1988,1999,11,0
Gary Grant ,546,15,13,1988,2000,12,0
Gary Grant ,546,15,13,1988,2001,13,0.1
Gary Harris ,547,19,2,2014,2015,1,-0.7
Gary Harris ,547,19,2,2014,2016,2,4
Gary Leonard ,548,34,3,1989,1990,1,0
Gary Leonard ,548,34,3,1989,1991,2,0
Gary Leonard ,548,34,3,1989,1992,3,0.1
Gary Plummer ,549,45,2,1984,1985,1,-0.2
Gary Plummer ,549,45,2,1984,1993,9,0.4
Gary Trent ,550,11,9,1995,1996,1,1.7
Gary Trent ,550,11,9,1995,1997,2,5.5
Gary Trent ,550,11,9,1995,1998,3,3.1
Gary Trent ,550,11,9,1995,1999,4,4
Gary Trent ,550,11,9,1995,2000,5,0.1
Gary Trent ,550,11,9,1995,2001,6,0.4
Gary Trent ,550,11,9,1995,2002,7,3
Gary Trent ,550,11,9,1995,2003,8,3.3
Gary Trent ,550,11,9,1995,2004,9,2.3
Gaylon Nickerson ,551,34,1,1994,1997,3,0.1
Geert Hammink ,552,26,3,1993,1994,1,0
Geert Hammink ,552,26,3,1993,1995,2,0
Geert Hammink ,552,26,3,1993,1996,3,0
Gene Banks ,553,28,6,1981,1982,1,3.5
Gene Banks ,553,28,6,1981,1983,2,7.9
Gene Banks ,553,28,6,1981,1984,3,6.2
Gene Banks ,553,28,6,1981,1985,4,5.6
Gene Banks ,553,28,6,1981,1986,5,4.3
Gene Banks ,553,28,6,1981,1987,6,3.6
Geoff Huston ,554,50,8,1979,1980,1,-0.3
Geoff Huston ,554,50,8,1979,1981,2,1.7
Geoff Huston ,554,50,8,1979,1982,3,3
Geoff Huston ,554,50,8,1979,1983,4,3.4
Geoff Huston ,554,50,8,1979,1984,5,2.6
Geoff Huston ,554,50,8,1979,1985,6,0
Geoff Huston ,554,50,8,1979,1986,7,1.8
Geoff Huston ,554,50,8,1979,1987,8,-0.4
George Hill ,555,26,8,2008,2009,1,2.1
George Hill ,555,26,8,2008,2010,2,6.7
George Hill ,555,26,8,2008,2011,3,6.1
George Hill ,555,26,8,2008,2012,4,4
George Hill ,555,26,8,2008,2013,5,9.7
George Hill ,555,26,8,2008,2014,6,7.8
George Hill ,555,26,8,2008,2015,7,5.4
George Hill ,555,26,8,2008,2016,8,6.2
George Johnson ,556,12,8,1978,1979,1,2.6
George Johnson ,556,12,8,1978,1980,2,2.6
George Johnson ,556,12,8,1978,1981,3,4.5
George Johnson ,556,12,8,1978,1982,4,2.5
George Johnson ,556,12,8,1978,1983,5,1
George Johnson ,556,12,8,1978,1984,6,3.2
George Johnson ,556,12,8,1978,1985,7,1.3
George Johnson ,556,12,8,1978,1986,8,0.6
George Lynch ,557,12,12,1993,1994,1,3.9
George Lynch ,557,12,12,1993,1995,2,0.9
George Lynch ,557,12,12,1993,1996,3,1.7
George Lynch ,557,12,12,1993,1997,4,1.5
George Lynch ,557,12,12,1993,1998,5,2.5
George Lynch ,557,12,12,1993,1999,6,2.6
George Lynch ,557,12,12,1993,2000,7,5.8
George Lynch ,557,12,12,1993,2001,8,6.5
George Lynch ,557,12,12,1993,2002,9,0.7
George Lynch ,557,12,12,1993,2003,10,3.5
George Lynch ,557,12,12,1993,2004,11,2.5
George Lynch ,557,12,12,1993,2005,12,0
George McCloud ,558,7,12,1989,1990,1,-0.7
George McCloud ,558,7,12,1989,1991,2,-0.4
George McCloud ,558,7,12,1989,1992,3,0.9
George McCloud ,558,7,12,1989,1993,4,1.4
George McCloud ,558,7,12,1989,1995,6,2.3
George McCloud ,558,7,12,1989,1996,7,5.8
George McCloud ,558,7,12,1989,1997,8,3.2
George McCloud ,558,7,12,1989,1998,9,2.4
George McCloud ,558,7,12,1989,1999,10,3.3
George McCloud ,558,7,12,1989,2000,11,3.8
George McCloud ,558,7,12,1989,2001,12,2.6
George McCloud ,558,7,12,1989,2002,13,0.1
George Zidek ,559,22,3,1995,1996,1,0.6
George Zidek ,559,22,3,1995,1997,2,0.3
George Zidek ,559,22,3,1995,1998,3,0
Gerald Glass ,560,20,4,1990,1991,1,0.5
Gerald Glass ,560,20,4,1990,1992,2,0.3
Gerald Glass ,560,20,4,1990,1993,3,0.9
Gerald Glass ,560,20,4,1990,1996,6,0.1
Gerald Green ,561,18,9,2005,2006,1,0.5
Gerald Green ,561,18,9,2005,2007,2,1.6
Gerald Green ,561,18,9,2005,2008,3,-0.4
Gerald Green ,561,18,9,2005,2009,4,0
Gerald Green ,561,18,9,2005,2012,7,1.2
Gerald Green ,561,18,9,2005,2013,8,1.3
Gerald Green ,561,18,9,2005,2014,9,6.1
Gerald Green ,561,18,9,2005,2015,10,1.9
Gerald Green ,561,18,9,2005,2016,11,1.7
Gerald Henderson ,562,12,7,2009,2010,1,0.4
Gerald Henderson ,562,12,7,2009,2011,2,2.4
Gerald Henderson ,562,12,7,2009,2012,3,1
Gerald Henderson ,562,12,7,2009,2013,4,3.3
Gerald Henderson ,562,12,7,2009,2014,5,3.6
Gerald Henderson ,562,12,7,2009,2015,6,3.6
Gerald Henderson ,562,12,7,2009,2016,7,2
Gerald Wallace ,563,25,14,2001,2002,1,0.6
Gerald Wallace ,563,25,14,2001,2003,2,0.9
Gerald Wallace ,563,25,14,2001,2004,3,0.4
Gerald Wallace ,563,25,14,2001,2005,4,2.4
Gerald Wallace ,563,25,14,2001,2006,5,6.4
Gerald Wallace ,563,25,14,2001,2007,6,7.7
Gerald Wallace ,563,25,14,2001,2008,7,4.6
Gerald Wallace ,563,25,14,2001,2009,8,9.5
Gerald Wallace ,563,25,14,2001,2010,9,11.5
Gerald Wallace ,563,25,14,2001,2011,10,6.2
Gerald Wallace ,563,25,14,2001,2012,11,4.8
Gerald Wallace ,563,25,14,2001,2013,12,3.1
Gerald Wallace ,563,25,14,2001,2014,13,1.3
Gerald Wallace ,563,25,14,2001,2015,14,0.1
Gerald Wilkins ,564,47,13,1985,1986,1,0.7
Gerald Wilkins ,564,47,13,1985,1987,2,3.3
Gerald Wilkins ,564,47,13,1985,1988,3,3.4
Gerald Wilkins ,564,47,13,1985,1989,4,4.3
Gerald Wilkins ,564,47,13,1985,1990,5,4.4
Gerald Wilkins ,564,47,13,1985,1991,6,3
Gerald Wilkins ,564,47,13,1985,1992,7,4
Gerald Wilkins ,564,47,13,1985,1993,8,3.5
Gerald Wilkins ,564,47,13,1985,1994,9,6.8
Gerald Wilkins ,564,47,13,1985,1996,11,-0.2
Gerald Wilkins ,564,47,13,1985,1997,12,2.1
Gerald Wilkins ,564,47,13,1985,1998,13,-1.2
Gerald Wilkins ,564,47,13,1985,1999,14,-0.2
Gheorghe Muresan ,565,30,6,1993,1994,1,1.3
Gheorghe Muresan ,565,30,6,1993,1995,2,4.1
Gheorghe Muresan ,565,30,6,1993,1996,3,8
Gheorghe Muresan ,565,30,6,1993,1997,4,5.3
Gheorghe Muresan ,565,30,6,1993,1999,6,-0.1
Gheorghe Muresan ,565,30,6,1993,2000,7,0.3
Giannis Antetokounmpo ,566,15,3,2013,2014,1,1.2
Giannis Antetokounmpo ,566,15,3,2013,2015,2,6.2
Giannis Antetokounmpo ,566,15,3,2013,2016,3,7.1
Gilbert Arenas ,567,30,11,2001,2002,1,2.7
Gilbert Arenas ,567,30,11,2001,2003,2,6.5
Gilbert Arenas ,567,30,11,2001,2004,3,2.6
Gilbert Arenas ,567,30,11,2001,2005,4,11.5
Gilbert Arenas ,567,30,11,2001,2006,5,13.6
Gilbert Arenas ,567,30,11,2001,2007,6,10.8
Gilbert Arenas ,567,30,11,2001,2008,7,0.6
Gilbert Arenas ,567,30,11,2001,2009,8,0.2
Gilbert Arenas ,567,30,11,2001,2010,9,1.8
Gilbert Arenas ,567,30,11,2001,2011,10,0.5
Gilbert Arenas ,567,30,11,2001,2012,11,0.4
Glen Davis ,568,35,8,2007,2008,1,2.5
Glen Davis ,568,35,8,2007,2009,2,3.7
Glen Davis ,568,35,8,2007,2010,3,1.6
Glen Davis ,568,35,8,2007,2011,4,4.9
Glen Davis ,568,35,8,2007,2012,5,1.7
Glen Davis ,568,35,8,2007,2013,6,0.8
Glen Davis ,568,35,8,2007,2014,7,2
Glen Davis ,568,35,8,2007,2015,8,1.4
Glen Rice ,569,4,15,1989,1990,1,1.4
Glen Rice ,569,4,15,1989,1991,2,4.4
Glen Rice ,569,4,15,1989,1992,3,7.9
Glen Rice ,569,4,15,1989,1993,4,6.3
Glen Rice ,569,4,15,1989,1994,5,10.2
Glen Rice ,569,4,15,1989,1995,6,10
Glen Rice ,569,4,15,1989,1996,7,8.3
Glen Rice ,569,4,15,1989,1997,8,10.8
Glen Rice ,569,4,15,1989,1998,9,9.3
Glen Rice ,569,4,15,1989,1999,10,2.2
Glen Rice ,569,4,15,1989,2000,11,9
Glen Rice ,569,4,15,1989,2001,12,5.7
Glen Rice ,569,4,15,1989,2002,13,0
Glen Rice ,569,4,15,1989,2003,14,3.3
Glen Rice ,569,4,15,1989,2004,15,-0.1
Glen Rice Jr. ,570,35,2,2013,2014,1,-0.1
Glen Rice Jr. ,570,35,2,2013,2015,2,-0.1
Glenn Hagan ,571,43,1,1978,1982,4,0.1
Glenn Robinson ,572,1,11,1994,1995,1,3.2
Glenn Robinson ,572,1,11,1994,1996,2,3.5
Glenn Robinson ,572,1,11,1994,1997,3,4.7
Glenn Robinson ,572,1,11,1994,1998,4,3.1
Glenn Robinson ,572,1,11,1994,1999,5,4
Glenn Robinson ,572,1,11,1994,2000,6,4.8
Glenn Robinson ,572,1,11,1994,2001,7,6.7
Glenn Robinson ,572,1,11,1994,2002,8,4.7
Glenn Robinson ,572,1,11,1994,2003,9,2.9
Glenn Robinson ,572,1,11,1994,2004,10,1.6
Glenn Robinson ,572,1,11,1994,2005,11,0.5
Glenn Robinson ,572,1,11,1994,2015,21,0.1
Glenn Robinson ,572,1,11,1994,2016,22,0.8
God Shammgod ,573,45,1,1997,1998,1,-0.1
Goran Dragic ,574,45,8,2008,2009,1,0.1
Goran Dragic ,574,45,8,2008,2010,2,2.8
Goran Dragic ,574,45,8,2008,2011,3,1
Goran Dragic ,574,45,8,2008,2012,4,5.1
Goran Dragic ,574,45,8,2008,2013,5,5.7
Goran Dragic ,574,45,8,2008,2014,6,10.3
Goran Dragic ,574,45,8,2008,2015,7,6.8
Goran Dragic ,574,45,8,2008,2016,8,4.7
Gordan Giricek ,575,40,6,1999,2003,4,1.6
Gordan Giricek ,575,40,6,1999,2004,5,2.4
Gordan Giricek ,575,40,6,1999,2005,6,1.8
Gordan Giricek ,575,40,6,1999,2006,7,-0.2
Gordan Giricek ,575,40,6,1999,2007,8,1.9
Gordan Giricek ,575,40,6,1999,2008,9,0.5
Gordon Hayward ,576,9,6,2010,2011,1,1.2
Gordon Hayward ,576,9,6,2010,2012,2,4.9
Gordon Hayward ,576,9,6,2010,2013,3,5.4
Gordon Hayward ,576,9,6,2010,2014,4,3.6
Gordon Hayward ,576,9,6,2010,2015,5,8.7
Gordon Hayward ,576,9,6,2010,2016,6,8.9
Gorgui Dieng ,577,21,3,2013,2014,1,2.2
Gorgui Dieng ,577,21,3,2013,2015,2,4.9
Gorgui Dieng ,577,21,3,2013,2016,3,5.9
Grant Hill ,578,3,18,1994,1995,1,5.4
Grant Hill ,578,3,18,1994,1996,2,11.7
Grant Hill ,578,3,18,1994,1997,3,14.6
Grant Hill ,578,3,18,1994,1998,4,10.2
Grant Hill ,578,3,18,1994,1999,5,7.3
Grant Hill ,578,3,18,1994,2000,6,10.7
Grant Hill ,578,3,18,1994,2001,7,0.3
Grant Hill ,578,3,18,1994,2002,8,1.2
Grant Hill ,578,3,18,1994,2003,9,2.5
Grant Hill ,578,3,18,1994,2005,11,6.6
Grant Hill ,578,3,18,1994,2006,12,1.7
Grant Hill ,578,3,18,1994,2007,13,5.1
Grant Hill ,578,3,18,1994,2008,14,5.9
Grant Hill ,578,3,18,1994,2009,15,5.3
Grant Hill ,578,3,18,1994,2010,16,5.5
Grant Hill ,578,3,18,1994,2011,17,4.4
Grant Hill ,578,3,18,1994,2012,18,1.6
Grant Hill ,578,3,18,1994,2013,19,-0.1
Grant Jerrett ,579,40,1,2013,2015,2,-0.1
Grant Long ,580,33,15,1988,1989,1,4.6
Grant Long ,580,33,15,1988,1990,2,2.7
Grant Long ,580,33,15,1988,1991,3,5
Grant Long ,580,33,15,1988,1992,4,7.7
Grant Long ,580,33,15,1988,1993,5,6.5
Grant Long ,580,33,15,1988,1994,6,5.1
Grant Long ,580,33,15,1988,1995,7,6.6
Grant Long ,580,33,15,1988,1996,8,8.4
Grant Long ,580,33,15,1988,1997,9,2.6
Grant Long ,580,33,15,1988,1998,10,1.6
Grant Long ,580,33,15,1988,1999,11,4.9
Grant Long ,580,33,15,1988,2000,12,1.4
Grant Long ,580,33,15,1988,2001,13,2.4
Grant Long ,580,33,15,1988,2002,14,0.2
Grant Long ,580,33,15,1988,2003,15,0.4
Granville Waiters ,581,39,5,1983,1984,1,1.3
Granville Waiters ,581,39,5,1983,1985,2,0.2
Granville Waiters ,581,39,5,1983,1986,3,-0.2
Granville Waiters ,581,39,5,1983,1987,4,0.5
Granville Waiters ,581,39,5,1983,1988,5,0
Greg Anderson ,582,23,10,1987,1988,1,2.3
Greg Anderson ,582,23,10,1987,1989,2,3.4
Greg Anderson ,582,23,10,1987,1990,3,2
Greg Anderson ,582,23,10,1987,1991,4,-0.3
Greg Anderson ,582,23,10,1987,1992,5,3
Greg Anderson ,582,23,10,1987,1994,7,3.4
Greg Anderson ,582,23,10,1987,1995,8,1.5
Greg Anderson ,582,23,10,1987,1996,9,0.4
Greg Anderson ,582,23,10,1987,1997,10,2.2
Greg Anderson ,582,23,10,1987,1998,11,0.7
Greg Anthony ,583,12,11,1991,1992,1,2.2
Greg Anthony ,583,12,11,1991,1993,2,4.6
Greg Anthony ,583,12,11,1991,1994,3,5.5
Greg Anthony ,583,12,11,1991,1995,4,2.9
Greg Anthony ,583,12,11,1991,1996,5,4.8
Greg Anthony ,583,12,11,1991,1997,6,3.5
Greg Anthony ,583,12,11,1991,1998,7,2.7
Greg Anthony ,583,12,11,1991,1999,8,2.8
Greg Anthony ,583,12,11,1991,2000,9,4.1
Greg Anthony ,583,12,11,1991,2001,10,1.6
Greg Anthony ,583,12,11,1991,2002,11,1.1
Greg Bunch ,584,34,1,1978,1979,1,0.1
Greg Butler ,585,37,3,1988,1989,1,-0.1
Greg Butler ,585,37,3,1988,1990,2,-0.1
Greg Butler ,585,37,3,1988,1991,3,-0.1
Greg Dreiling ,586,26,10,1986,1987,1,0.2
Greg Dreiling ,586,26,10,1986,1988,2,0.1
Greg Dreiling ,586,26,10,1986,1989,3,0.4
Greg Dreiling ,586,26,10,1986,1990,4,0.2
Greg Dreiling ,586,26,10,1986,1991,5,1.1
Greg Dreiling ,586,26,10,1986,1992,6,0.5
Greg Dreiling ,586,26,10,1986,1993,7,0.1
Greg Dreiling ,586,26,10,1986,1994,8,0.6
Greg Dreiling ,586,26,10,1986,1995,9,0.6
Greg Dreiling ,586,26,10,1986,1997,11,0.4
Greg Foster ,587,35,13,1990,1991,1,0.6
Greg Foster ,587,35,13,1990,1992,2,0.5
Greg Foster ,587,35,13,1990,1993,3,0.2
Greg Foster ,587,35,13,1990,1994,4,0
Greg Foster ,587,35,13,1990,1995,5,1
Greg Foster ,587,35,13,1990,1996,6,0.6
Greg Foster ,587,35,13,1990,1997,7,1
Greg Foster ,587,35,13,1990,1998,8,1.3
Greg Foster ,587,35,13,1990,1999,9,0.1
Greg Foster ,587,35,13,1990,2000,10,0.1
Greg Foster ,587,35,13,1990,2001,11,0.4
Greg Foster ,587,35,13,1990,2002,12,0
Greg Foster ,587,35,13,1990,2003,13,-0.3
Greg Graham ,588,17,5,1993,1994,1,0.1
Greg Graham ,588,17,5,1993,1995,2,0.3
Greg Graham ,588,17,5,1993,1996,3,0.8
Greg Graham ,588,17,5,1993,1997,4,0.3
Greg Graham ,588,17,5,1993,1998,5,-0.1
Greg Kelser ,589,4,6,1979,1980,1,1.4
Greg Kelser ,589,4,6,1979,1981,2,0
Greg Kelser ,589,4,6,1979,1982,3,0.8
Greg Kelser ,589,4,6,1979,1983,4,3.9
Greg Kelser ,589,4,6,1979,1984,5,2.5
Greg Kelser ,589,4,6,1979,1985,6,0.1
Greg Kite ,590,21,12,1983,1984,1,0
Greg Kite ,590,21,12,1983,1985,2,0.1
Greg Kite ,590,21,12,1983,1986,3,0.1
Greg Kite ,590,21,12,1983,1987,4,0.7
Greg Kite ,590,21,12,1983,1988,5,0.3
Greg Kite ,590,21,12,1983,1989,6,0.1
Greg Kite ,590,21,12,1983,1990,7,0.8
Greg Kite ,590,21,12,1983,1991,8,2
Greg Kite ,590,21,12,1983,1992,9,1.4
Greg Kite ,590,21,12,1983,1993,10,0.6
Greg Kite ,590,21,12,1983,1994,11,-0.1
Greg Kite ,590,21,12,1983,1995,12,-0.3
Greg Minor ,591,25,5,1994,1995,1,2.1
Greg Minor ,591,25,5,1994,1996,2,3
Greg Minor ,591,25,5,1994,1997,3,0.6
Greg Minor ,591,25,5,1994,1998,4,1.7
Greg Minor ,591,25,5,1994,1999,5,0.8
Greg Monroe ,592,7,6,2010,2011,1,6.6
Greg Monroe ,592,7,6,2010,2012,2,7
Greg Monroe ,592,7,6,2010,2013,3,5.9
Greg Monroe ,592,7,6,2010,2014,4,5.9
Greg Monroe ,592,7,6,2010,2015,5,6.8
Greg Monroe ,592,7,6,2010,2016,6,7.5
Greg Oden ,593,1,3,2007,2009,2,4.6
Greg Oden ,593,1,3,2007,2010,3,2.2
Greg Oden ,593,1,3,2007,2014,7,0.5
Greg Ostertag ,594,28,11,1995,1996,1,1.4
Greg Ostertag ,594,28,11,1995,1997,2,5.9
Greg Ostertag ,594,28,11,1995,1998,3,2.2
Greg Ostertag ,594,28,11,1995,1999,4,3.8
Greg Ostertag ,594,28,11,1995,2000,5,4.2
Greg Ostertag ,594,28,11,1995,2001,6,3.8
Greg Ostertag ,594,28,11,1995,2002,7,2.1
Greg Ostertag ,594,28,11,1995,2003,8,3.4
Greg Ostertag ,594,28,11,1995,2004,9,5
Greg Ostertag ,594,28,11,1995,2005,10,0.7
Greg Ostertag ,594,28,11,1995,2006,11,1.3
Greg Stokes ,595,33,2,1985,1986,1,0.5
Greg Stokes ,595,33,2,1985,1990,5,-0.2
Greg Sutton ,596,49,3,1991,1992,1,-0.1
Greg Sutton ,596,49,3,1991,1995,4,0.8
Greg Sutton ,596,49,3,1991,1996,5,0.2
Greivis Vasquez ,597,28,6,2010,2011,1,0.5
Greivis Vasquez ,597,28,6,2010,2012,2,2.3
Greivis Vasquez ,597,28,6,2010,2013,3,3.8
Greivis Vasquez ,597,28,6,2010,2014,4,3.6
Greivis Vasquez ,597,28,6,2010,2015,5,2.8
Greivis Vasquez ,597,28,6,2010,2016,6,-0.3
Guy Morgan ,598,40,1,1982,1983,1,-0.1
Guy Williams ,599,34,2,1983,1985,2,0.1
Guy Williams ,599,34,2,1983,1986,3,0
Ha Seung-Jin ,600,46,2,2004,2005,1,-0.2
Ha Seung-Jin ,600,46,2,2004,2006,2,0
Hakim Warrick ,601,19,8,2005,2006,1,0.8
Hakim Warrick ,601,19,8,2005,2007,2,3.7
Hakim Warrick ,601,19,8,2005,2008,3,3.3
Hakim Warrick ,601,19,8,2005,2009,4,4.7
Hakim Warrick ,601,19,8,2005,2010,5,4
Hakim Warrick ,601,19,8,2005,2011,6,3.4
Hakim Warrick ,601,19,8,2005,2012,7,0.5
Hakim Warrick ,601,19,8,2005,2013,8,0
Hanno Mottola ,602,40,2,2000,2001,1,0.4
Hanno Mottola ,602,40,2,2000,2002,2,0.5
Harold Miner ,603,12,4,1992,1993,1,2
Harold Miner ,603,12,4,1992,1994,2,2.7
Harold Miner ,603,12,4,1992,1995,3,-0.4
Harold Miner ,603,12,4,1992,1996,4,-0.1
Harold Pressley ,604,17,4,1986,1987,1,0.7
Harold Pressley ,604,17,4,1986,1988,2,2.2
Harold Pressley ,604,17,4,1986,1989,3,4.8
Harold Pressley ,604,17,4,1986,1990,4,2.3
Harrison Barnes ,605,7,4,2012,2013,1,2.8
Harrison Barnes ,605,7,4,2012,2014,2,3.2
Harrison Barnes ,605,7,4,2012,2015,3,6.7
Harrison Barnes ,605,7,4,2012,2016,4,4.9
Harry Davis ,606,33,2,1978,1979,1,0.3
Harry Davis ,606,33,2,1978,1980,2,0
Harvey Grant ,607,12,11,1988,1989,1,1.7
Harvey Grant ,607,12,11,1988,1990,2,2.6
Harvey Grant ,607,12,11,1988,1991,3,6.7
Harvey Grant ,607,12,11,1988,1992,4,4.3
Harvey Grant ,607,12,11,1988,1993,5,5
Harvey Grant ,607,12,11,1988,1994,6,3.9
Harvey Grant ,607,12,11,1988,1995,7,4
Harvey Grant ,607,12,11,1988,1996,8,4
Harvey Grant ,607,12,11,1988,1997,9,2.7
Harvey Grant ,607,12,11,1988,1998,10,0.7
Harvey Grant ,607,12,11,1988,1999,11,0.8
Hasheem Thabeet ,608,2,5,2009,2010,1,2
Hasheem Thabeet ,608,2,5,2009,2011,2,0.3
Hasheem Thabeet ,608,2,5,2009,2012,3,0.3
Hasheem Thabeet ,608,2,5,2009,2013,4,2.2
Hasheem Thabeet ,608,2,5,2009,2014,5,0
Hassan Whiteside ,609,33,4,2010,2011,1,0
Hassan Whiteside ,609,33,4,2010,2012,2,0.2
Hassan Whiteside ,609,33,4,2010,2015,5,5.3
Hassan Whiteside ,609,33,4,2010,2016,6,10.3
Hawkeye Whitney ,610,16,2,1980,1981,1,1.5
Hawkeye Whitney ,610,16,2,1980,1982,2,-0.1
Haywoode Workman ,611,49,8,1989,1990,1,0.1
Haywoode Workman ,611,49,8,1989,1991,2,2.5
Haywoode Workman ,611,49,8,1989,1994,5,2.8
Haywoode Workman ,611,49,8,1989,1995,6,1.9
Haywoode Workman ,611,49,8,1989,1996,7,1.4
Haywoode Workman ,611,49,8,1989,1997,8,0.1
Haywoode Workman ,611,49,8,1989,1999,10,1.6
Haywoode Workman ,611,49,8,1989,2000,11,0.3
Hedo Turkoglu ,612,16,15,2000,2001,1,2.8
Hedo Turkoglu ,612,16,15,2000,2002,2,5.2
Hedo Turkoglu ,612,16,15,2000,2003,3,2.6
Hedo Turkoglu ,612,16,15,2000,2004,4,6.7
Hedo Turkoglu ,612,16,15,2000,2005,5,3.4
Hedo Turkoglu ,612,16,15,2000,2006,6,7.6
Hedo Turkoglu ,612,16,15,2000,2007,7,4.9
Hedo Turkoglu ,612,16,15,2000,2008,8,9
Hedo Turkoglu ,612,16,15,2000,2009,9,7.3
Hedo Turkoglu ,612,16,15,2000,2010,10,3.4
Hedo Turkoglu ,612,16,15,2000,2011,11,6.8
Hedo Turkoglu ,612,16,15,2000,2012,12,2.1
Hedo Turkoglu ,612,16,15,2000,2013,13,-0.5
Hedo Turkoglu ,612,16,15,2000,2014,14,0.8
Hedo Turkoglu ,612,16,15,2000,2015,15,1.2
Herb Williams ,613,14,18,1981,1982,1,4.6
Herb Williams ,613,14,18,1981,1983,2,3.5
Herb Williams ,613,14,18,1981,1984,3,2.8
Herb Williams ,613,14,18,1981,1985,4,2.2
Herb Williams ,613,14,18,1981,1986,5,6.2
Herb Williams ,613,14,18,1981,1987,6,4.7
Herb Williams ,613,14,18,1981,1988,7,1.8
Herb Williams ,613,14,18,1981,1989,8,1.4
Herb Williams ,613,14,18,1981,1990,9,2.2
Herb Williams ,613,14,18,1981,1991,10,1.7
Herb Williams ,613,14,18,1981,1992,11,0.8
Herb Williams ,613,14,18,1981,1993,12,1.1
Herb Williams ,613,14,18,1981,1994,13,1.6
Herb Williams ,613,14,18,1981,1995,14,0.6
Herb Williams ,613,14,18,1981,1996,15,0.4
Herb Williams ,613,14,18,1981,1997,16,0.2
Herb Williams ,613,14,18,1981,1998,17,0.2
Herb Williams ,613,14,18,1981,1999,18,0.1
Hersey Hawkins ,614,6,13,1988,1989,1,4
Hersey Hawkins ,614,6,13,1988,1990,2,8
Hersey Hawkins ,614,6,13,1988,1991,3,9.8
Hersey Hawkins ,614,6,13,1988,1992,4,7.8
Hersey Hawkins ,614,6,13,1988,1993,5,8.5
Hersey Hawkins ,614,6,13,1988,1994,6,6.5
Hersey Hawkins ,614,6,13,1988,1995,7,8.7
Hersey Hawkins ,614,6,13,1988,1996,8,9.5
Hersey Hawkins ,614,6,13,1988,1997,9,10.9
Hersey Hawkins ,614,6,13,1988,1998,10,8.6
Hersey Hawkins ,614,6,13,1988,1999,11,3.5
Hersey Hawkins ,614,6,13,1988,2000,12,2.6
Hersey Hawkins ,614,6,13,1988,2001,13,2.3
Hilton Armstrong ,615,12,6,2006,2007,1,1.2
Hilton Armstrong ,615,12,6,2006,2008,2,0.5
Hilton Armstrong ,615,12,6,2006,2009,3,1.5
Hilton Armstrong ,615,12,6,2006,2010,4,-0.1
Hilton Armstrong ,615,12,6,2006,2011,5,0.5
Hilton Armstrong ,615,12,6,2006,2014,8,0.3
Hollis Copeland ,616,46,2,1978,1980,2,1.2
Hollis Copeland ,616,46,2,1978,1982,4,0.1
Horace Grant ,617,10,17,1987,1988,1,4.2
Horace Grant ,617,10,17,1987,1989,2,6.4
Horace Grant ,617,10,17,1987,1990,3,8
Horace Grant ,617,10,17,1987,1991,4,10.3
Horace Grant ,617,10,17,1987,1992,5,14.1
Horace Grant ,617,10,17,1987,1993,6,9.1
Horace Grant ,617,10,17,1987,1994,7,10
Horace Grant ,617,10,17,1987,1995,8,9.5
Horace Grant ,617,10,17,1987,1996,9,8
Horace Grant ,617,10,17,1987,1997,10,7.7
Horace Grant ,617,10,17,1987,1998,11,7.1
Horace Grant ,617,10,17,1987,1999,12,4.1
Horace Grant ,617,10,17,1987,2000,13,5.2
Horace Grant ,617,10,17,1987,2001,14,6.5
Horace Grant ,617,10,17,1987,2002,15,5.6
Horace Grant ,617,10,17,1987,2003,16,0.2
Horace Grant ,617,10,17,1987,2004,17,2
Hot Rod Williams ,618,45,13,1985,1987,2,7.5
Hot Rod Williams ,618,45,13,1985,1988,3,5.7
Hot Rod Williams ,618,45,13,1985,1989,4,7.7
Hot Rod Williams ,618,45,13,1985,1990,5,8.7
Hot Rod Williams ,618,45,13,1985,1991,6,2.4
Hot Rod Williams ,618,45,13,1985,1992,7,9.2
Hot Rod Williams ,618,45,13,1985,1993,8,4.5
Hot Rod Williams ,618,45,13,1985,1994,9,7.4
Hot Rod Williams ,618,45,13,1985,1995,10,5.3
Hot Rod Williams ,618,45,13,1985,1996,11,2.8
Hot Rod Williams ,618,45,13,1985,1997,12,5.3
Hot Rod Williams ,618,45,13,1985,1998,13,3.7
Hot Rod Williams ,618,45,13,1985,1999,14,0.4
Howard Carter ,619,15,2,1983,1984,1,0.4
Howard Carter ,619,15,2,1983,1985,2,-0.4
Howard Eisley ,620,30,12,1994,1995,1,-0.5
Howard Eisley ,620,30,12,1994,1996,2,1
Howard Eisley ,620,30,12,1994,1997,3,1.2
Howard Eisley ,620,30,12,1994,1998,4,2.9
Howard Eisley ,620,30,12,1994,1999,5,1.3
Howard Eisley ,620,30,12,1994,2000,6,3
Howard Eisley ,620,30,12,1994,2001,7,4.4
Howard Eisley ,620,30,12,1994,2002,8,-0.3
Howard Eisley ,620,30,12,1994,2003,9,4.5
Howard Eisley ,620,30,12,1994,2004,10,1.7
Howard Eisley ,620,30,12,1994,2005,11,0
Howard Eisley ,620,30,12,1994,2006,12,0.3
Howard Wood ,621,27,1,1981,1982,1,0.3
Hubert Davis ,622,20,12,1992,1993,1,1.2
Hubert Davis ,622,20,12,1992,1994,2,4.2
Hubert Davis ,622,20,12,1992,1995,3,4.8
Hubert Davis ,622,20,12,1992,1996,4,5.6
Hubert Davis ,622,20,12,1992,1997,5,0.1
Hubert Davis ,622,20,12,1992,1998,6,3.4
Hubert Davis ,622,20,12,1992,1999,7,1.6
Hubert Davis ,622,20,12,1992,2000,8,2.5
Hubert Davis ,622,20,12,1992,2001,9,2.2
Hubert Davis ,622,20,12,1992,2002,10,1.7
Hubert Davis ,622,20,12,1992,2003,11,0.5
Hubert Davis ,622,20,12,1992,2004,12,-0.1
Ian Mahinmi ,623,28,8,2005,2008,3,0.2
Ian Mahinmi ,623,28,8,2005,2010,5,0.7
Ian Mahinmi ,623,28,8,2005,2011,6,1.8
Ian Mahinmi ,623,28,8,2005,2012,7,3.4
Ian Mahinmi ,623,28,8,2005,2013,8,2.3
Ian Mahinmi ,623,28,8,2005,2014,9,3.3
Ian Mahinmi ,623,28,8,2005,2015,10,2.1
Ian Mahinmi ,623,28,8,2005,2016,11,6.2
Ike Diogu ,624,9,6,2005,2006,1,2.6
Ike Diogu ,624,9,6,2005,2007,2,1.5
Ike Diogu ,624,9,6,2005,2008,3,0.7
Ike Diogu ,624,9,6,2005,2009,4,0.7
Ike Diogu ,624,9,6,2005,2011,6,1
Ike Diogu ,624,9,6,2005,2012,7,0
Iman Shumpert ,625,17,5,2011,2012,1,2.4
Iman Shumpert ,625,17,5,2011,2013,2,1.9
Iman Shumpert ,625,17,5,2011,2014,3,2
Iman Shumpert ,625,17,5,2011,2015,4,1.5
Iman Shumpert ,625,17,5,2011,2016,5,1.7
Isaac Austin ,626,48,9,1991,1992,1,0.3
Isaac Austin ,626,48,9,1991,1993,2,0.3
Isaac Austin ,626,48,9,1991,1994,3,0.2
Isaac Austin ,626,48,9,1991,1997,6,4
Isaac Austin ,626,48,9,1991,1998,7,3.6
Isaac Austin ,626,48,9,1991,1999,8,1.2
Isaac Austin ,626,48,9,1991,2000,9,0
Isaac Austin ,626,48,9,1991,2001,10,-0.5
Isaac Austin ,626,48,9,1991,2002,11,0
Isaiah Canaan ,627,34,3,2013,2014,1,0.2
Isaiah Canaan ,627,34,3,2013,2015,2,1.4
Isaiah Canaan ,627,34,3,2013,2016,3,1.4
Isaiah Morris ,628,37,1,1992,1993,1,0
Isaiah Rider ,629,5,9,1993,1994,1,1.7
Isaiah Rider ,629,5,9,1993,1995,2,1.9
Isaiah Rider ,629,5,9,1993,1996,3,3.4
Isaiah Rider ,629,5,9,1993,1997,4,5
Isaiah Rider ,629,5,9,1993,1998,5,5.8
Isaiah Rider ,629,5,9,1993,1999,6,2.5
Isaiah Rider ,629,5,9,1993,2000,7,1.6
Isaiah Rider ,629,5,9,1993,2001,8,0.8
Isaiah Rider ,629,5,9,1993,2002,9,0.2
J.J. Anderson ,630,36,3,1982,1983,1,2.3
J.J. Anderson ,630,36,3,1982,1984,2,0.1
J.J. Anderson ,630,36,3,1982,1985,3,0.2
J.J. Hickson ,631,19,8,2008,2009,1,1.5
J.J. Hickson ,631,19,8,2008,2010,2,4.3
J.J. Hickson ,631,19,8,2008,2011,3,1.5
J.J. Hickson ,631,19,8,2008,2012,4,1.7
J.J. Hickson ,631,19,8,2008,2013,5,6.9
J.J. Hickson ,631,19,8,2008,2014,6,3.3
J.J. Hickson ,631,19,8,2008,2015,7,1.8
J.J. Hickson ,631,19,8,2008,2016,8,0.8
J.J. Redick ,632,11,10,2006,2007,1,1.7
J.J. Redick ,632,11,10,2006,2008,2,0.5
J.J. Redick ,632,11,10,2006,2009,3,2.3
J.J. Redick ,632,11,10,2006,2010,4,6.5
J.J. Redick ,632,11,10,2006,2011,5,4.5
J.J. Redick ,632,11,10,2006,2012,6,5.2
J.J. Redick ,632,11,10,2006,2013,7,4.5
J.J. Redick ,632,11,10,2006,2014,8,3
J.J. Redick ,632,11,10,2006,2015,9,6.7
J.J. Redick ,632,11,10,2006,2016,10,6.7
J.R. Giddens ,633,30,2,2008,2009,1,0
J.R. Giddens ,633,30,2,2008,2010,2,0.1
J.R. Reid ,634,5,11,1989,1990,1,1.1
J.R. Reid ,634,5,11,1989,1991,2,1.8
J.R. Reid ,634,5,11,1989,1992,3,2.1
J.R. Reid ,634,5,11,1989,1993,4,3.4
J.R. Reid ,634,5,11,1989,1994,5,3
J.R. Reid ,634,5,11,1989,1995,6,3.5
J.R. Reid ,634,5,11,1989,1996,7,2.5
J.R. Reid ,634,5,11,1989,1998,9,1.8
J.R. Reid ,634,5,11,1989,1999,10,2.5
J.R. Reid ,634,5,11,1989,2000,11,0.7
J.R. Reid ,634,5,11,1989,2001,12,0.1
J.R. Smith ,635,18,12,2004,2005,1,0.2
J.R. Smith ,635,18,12,2004,2006,2,1.2
J.R. Smith ,635,18,12,2004,2007,3,3.7
J.R. Smith ,635,18,12,2004,2008,4,3.7
J.R. Smith ,635,18,12,2004,2009,5,5.8
J.R. Smith ,635,18,12,2004,2010,6,2.7
J.R. Smith ,635,18,12,2004,2011,7,5
J.R. Smith ,635,18,12,2004,2012,8,2.5
J.R. Smith ,635,18,12,2004,2013,9,6.7
J.R. Smith ,635,18,12,2004,2014,10,3.7
J.R. Smith ,635,18,12,2004,2015,11,3.7
J.R. Smith ,635,18,12,2004,2016,12,5.5
Jabari Parker ,636,2,2,2014,2015,1,1.3
Jabari Parker ,636,2,2,2014,2016,2,3.6
Jabari Smith ,637,45,4,2000,2001,1,0.2
Jabari Smith ,637,45,4,2000,2002,2,0.5
Jabari Smith ,637,45,4,2000,2004,4,0
Jabari Smith ,637,45,4,2000,2005,5,0.7
Jack Givens ,638,16,2,1978,1979,1,2.1
Jack Givens ,638,16,2,1978,1980,2,2.2
Jackson Vroman ,639,31,2,2004,2005,1,-0.1
Jackson Vroman ,639,31,2,2004,2006,2,0.1
Jacque Vaughn ,640,27,12,1997,1998,1,-0.4
Jacque Vaughn ,640,27,12,1997,1999,2,0.1
Jacque Vaughn ,640,27,12,1997,2000,3,0.4
Jacque Vaughn ,640,27,12,1997,2001,4,3
Jacque Vaughn ,640,27,12,1997,2002,5,3.5
Jacque Vaughn ,640,27,12,1997,2003,6,2
Jacque Vaughn ,640,27,12,1997,2004,7,0
Jacque Vaughn ,640,27,12,1997,2005,8,1.8
Jacque Vaughn ,640,27,12,1997,2006,9,1.5
Jacque Vaughn ,640,27,12,1997,2007,10,1.7
Jacque Vaughn ,640,27,12,1997,2008,11,1.6
Jacque Vaughn ,640,27,12,1997,2009,12,0.1
Jae Crowder ,641,34,4,2012,2013,1,1.5
Jae Crowder ,641,34,4,2012,2014,2,2.3
Jae Crowder ,641,34,4,2012,2015,3,3.9
Jae Crowder ,641,34,4,2012,2016,4,7.3
Jahidi White ,642,43,7,1998,1999,1,0.2
Jahidi White ,642,43,7,1998,2000,2,3.2
Jahidi White ,642,43,7,1998,2001,3,2.1
Jahidi White ,642,43,7,1998,2002,4,3.3
Jahidi White ,642,43,7,1998,2003,5,0.6
Jahidi White ,642,43,7,1998,2004,6,1.2
Jahidi White ,642,43,7,1998,2005,7,-0.1
Jahlil Okafor ,643,3,1,2015,2016,1,1.2
JaJuan Johnson ,644,27,1,2011,2012,1,0.2
Jake Tsakalidis ,645,25,7,2000,2001,1,1.3
Jake Tsakalidis ,645,25,7,2000,2002,2,2.8
Jake Tsakalidis ,645,25,7,2000,2003,3,0.9
Jake Tsakalidis ,645,25,7,2000,2004,4,1.2
Jake Tsakalidis ,645,25,7,2000,2005,5,0.6
Jake Tsakalidis ,645,25,7,2000,2006,6,2.8
Jake Tsakalidis ,645,25,7,2000,2007,7,0.3
Jake Voskuhl ,646,33,9,2000,2001,1,0
Jake Voskuhl ,646,33,9,2000,2002,2,2.7
Jake Voskuhl ,646,33,9,2000,2003,3,2.5
Jake Voskuhl ,646,33,9,2000,2004,4,3.3
Jake Voskuhl ,646,33,9,2000,2005,5,0.6
Jake Voskuhl ,646,33,9,2000,2006,6,1
Jake Voskuhl ,646,33,9,2000,2007,7,1.7
Jake Voskuhl ,646,33,9,2000,2008,8,0.2
Jake Voskuhl ,646,33,9,2000,2009,9,-0.3
Jalen Rose ,647,13,13,1994,1995,1,3.8
Jalen Rose ,647,13,13,1994,1996,2,2.9
Jalen Rose ,647,13,13,1994,1997,3,2.1
Jalen Rose ,647,13,13,1994,1998,4,3.3
Jalen Rose ,647,13,13,1994,1999,5,1.8
Jalen Rose ,647,13,13,1994,2000,6,7.3
Jalen Rose ,647,13,13,1994,2001,7,7.3
Jalen Rose ,647,13,13,1994,2002,8,5.7
Jalen Rose ,647,13,13,1994,2003,9,3.6
Jalen Rose ,647,13,13,1994,2004,10,1.5
Jalen Rose ,647,13,13,1994,2005,11,4.8
Jalen Rose ,647,13,13,1994,2006,12,2.5
Jalen Rose ,647,13,13,1994,2007,13,0.6
Jamaal Franklin ,648,41,2,2013,2014,1,0
Jamaal Franklin ,648,41,2,2013,2015,2,0
Jamaal Magloire ,649,19,12,2000,2001,1,2.6
Jamaal Magloire ,649,19,12,2000,2002,2,5.7
Jamaal Magloire ,649,19,12,2000,2003,3,6.7
Jamaal Magloire ,649,19,12,2000,2004,4,7.6
Jamaal Magloire ,649,19,12,2000,2005,5,0.3
Jamaal Magloire ,649,19,12,2000,2006,6,2
Jamaal Magloire ,649,19,12,2000,2007,7,1.1
Jamaal Magloire ,649,19,12,2000,2008,8,-0.6
Jamaal Magloire ,649,19,12,2000,2009,9,1.3
Jamaal Magloire ,649,19,12,2000,2010,10,0.6
Jamaal Magloire ,649,19,12,2000,2011,11,0.6
Jamaal Magloire ,649,19,12,2000,2012,12,-0.2
Jamaal Tinsley ,650,27,11,2001,2002,1,1.7
Jamaal Tinsley ,650,27,11,2001,2003,2,3.7
Jamaal Tinsley ,650,27,11,2001,2004,3,4.4
Jamaal Tinsley ,650,27,11,2001,2005,4,2.8
Jamaal Tinsley ,650,27,11,2001,2006,5,0.7
Jamaal Tinsley ,650,27,11,2001,2007,6,2.8
Jamaal Tinsley ,650,27,11,2001,2008,7,0.8
Jamaal Tinsley ,650,27,11,2001,2010,9,-0.3
Jamaal Tinsley ,650,27,11,2001,2012,11,0.1
Jamaal Tinsley ,650,27,11,2001,2013,12,0.9
Jamaal Tinsley ,650,27,11,2001,2014,13,-0.3
Jamal Crawford ,651,8,16,2000,2001,1,-0.9
Jamal Crawford ,651,8,16,2000,2002,2,0.6
Jamal Crawford ,651,8,16,2000,2003,3,2.8
Jamal Crawford ,651,8,16,2000,2004,4,4.1
Jamal Crawford ,651,8,16,2000,2005,5,4.2
Jamal Crawford ,651,8,16,2000,2006,6,4.5
Jamal Crawford ,651,8,16,2000,2007,7,3.1
Jamal Crawford ,651,8,16,2000,2008,8,5
Jamal Crawford ,651,8,16,2000,2009,9,3.3
Jamal Crawford ,651,8,16,2000,2010,10,7.3
Jamal Crawford ,651,8,16,2000,2011,11,3.4
Jamal Crawford ,651,8,16,2000,2012,12,2.3
Jamal Crawford ,651,8,16,2000,2013,13,5.4
Jamal Crawford ,651,8,16,2000,2014,14,5.3
Jamal Crawford ,651,8,16,2000,2015,15,3.6
Jamal Crawford ,651,8,16,2000,2016,16,3.3
Jamal Mashburn ,652,4,11,1993,1994,1,0.9
Jamal Mashburn ,652,4,11,1993,1995,2,6.3
Jamal Mashburn ,652,4,11,1993,1996,3,0.2
Jamal Mashburn ,652,4,11,1993,1997,4,3.6
Jamal Mashburn ,652,4,11,1993,1998,5,4.1
Jamal Mashburn ,652,4,11,1993,1999,6,1.8
Jamal Mashburn ,652,4,11,1993,2000,7,6.4
Jamal Mashburn ,652,4,11,1993,2001,8,7.3
Jamal Mashburn ,652,4,11,1993,2002,9,3.4
Jamal Mashburn ,652,4,11,1993,2003,10,9
Jamal Mashburn ,652,4,11,1993,2004,11,0.7
Jamal Sampson ,653,46,5,2002,2003,1,0
Jamal Sampson ,653,46,5,2002,2004,2,0.4
Jamal Sampson ,653,46,5,2002,2005,3,0.5
Jamal Sampson ,653,46,5,2002,2006,4,0.2
Jamal Sampson ,653,46,5,2002,2007,5,0.2
Jameer Nelson ,654,20,12,2004,2005,1,2.5
Jameer Nelson ,654,20,12,2004,2006,2,4.9
Jameer Nelson ,654,20,12,2004,2007,3,4
Jameer Nelson ,654,20,12,2004,2008,4,5.6
Jameer Nelson ,654,20,12,2004,2009,5,6
Jameer Nelson ,654,20,12,2004,2010,6,5
Jameer Nelson ,654,20,12,2004,2011,7,6.6
Jameer Nelson ,654,20,12,2004,2012,8,3.5
Jameer Nelson ,654,20,12,2004,2013,9,2.1
Jameer Nelson ,654,20,12,2004,2014,10,2.8
Jameer Nelson ,654,20,12,2004,2015,11,1.4
Jameer Nelson ,654,20,12,2004,2016,12,0.5
James Anderson ,655,20,5,2010,2011,1,0.3
James Anderson ,655,20,5,2010,2012,2,0.5
James Anderson ,655,20,5,2010,2013,3,0.9
James Anderson ,655,20,5,2010,2014,4,1.9
James Anderson ,655,20,5,2010,2016,6,-0.3
James Augustine ,656,41,2,2006,2007,1,0
James Augustine ,656,41,2,2006,2008,2,0.3
James Bailey ,657,6,9,1979,1980,1,1
James Bailey ,657,6,9,1979,1981,2,4.9
James Bailey ,657,6,9,1979,1982,3,2.9
James Bailey ,657,6,9,1979,1983,4,2
James Bailey ,657,6,9,1979,1984,5,2.3
James Bailey ,657,6,9,1979,1985,6,0.6
James Bailey ,657,6,9,1979,1986,7,1.9
James Bailey ,657,6,9,1979,1987,8,0.3
James Bailey ,657,6,9,1979,1988,9,0.4
James Collins ,658,36,1,1997,1998,1,0
James Cotton ,659,32,2,1997,1998,1,-0.1
James Cotton ,659,32,2,1997,1999,2,0.1
James Ennis ,660,50,2,2013,2015,2,1.9
James Ennis ,660,50,2,2013,2016,3,0.9
James Harden ,661,3,7,2009,2010,1,4.5
James Harden ,661,3,7,2009,2011,2,7.1
James Harden ,661,3,7,2009,2012,3,9.3
James Harden ,661,3,7,2009,2013,4,12.8
James Harden ,661,3,7,2009,2014,5,12.8
James Harden ,661,3,7,2009,2015,6,16.4
James Harden ,661,3,7,2009,2016,7,13.3
James Hardy ,662,11,4,1978,1979,1,1.3
James Hardy ,662,11,4,1978,1980,2,1.8
James Hardy ,662,11,4,1978,1981,3,0.7
James Hardy ,662,11,4,1978,1982,4,2.5
James Johnson ,663,16,7,2009,2010,1,0.8
James Johnson ,663,16,7,2009,2011,2,0.6
James Johnson ,663,16,7,2009,2012,3,2.6
James Johnson ,663,16,7,2009,2013,4,-0.5
James Johnson ,663,16,7,2009,2014,5,3
James Johnson ,663,16,7,2009,2015,6,4.1
James Johnson ,663,16,7,2009,2016,7,1.3
James Jones ,664,49,13,2003,2004,1,0
James Jones ,664,49,13,2003,2005,2,2.5
James Jones ,664,49,13,2003,2006,3,4
James Jones ,664,49,13,2003,2007,4,2.2
James Jones ,664,49,13,2003,2008,5,3.7
James Jones ,664,49,13,2003,2009,6,0.9
James Jones ,664,49,13,2003,2010,7,1
James Jones ,664,49,13,2003,2011,8,4.7
James Jones ,664,49,13,2003,2012,9,1.7
James Jones ,664,49,13,2003,2013,10,0.2
James Jones ,664,49,13,2003,2014,11,0.7
James Jones ,664,49,13,2003,2015,12,1.5
James Jones ,664,49,13,2003,2016,13,1.2
James Lang ,665,48,1,2003,2007,4,0.1
James Posey ,666,18,12,1999,2000,1,4.3
James Posey ,666,18,12,1999,2001,2,3.8
James Posey ,666,18,12,1999,2002,3,2.7
James Posey ,666,18,12,1999,2003,4,5.4
James Posey ,666,18,12,1999,2004,5,10
James Posey ,666,18,12,1999,2005,6,2.3
James Posey ,666,18,12,1999,2006,7,4.2
James Posey ,666,18,12,1999,2007,8,5.2
James Posey ,666,18,12,1999,2008,9,6.2
James Posey ,666,18,12,1999,2009,10,4.2
James Posey ,666,18,12,1999,2010,11,2.4
James Posey ,666,18,12,1999,2011,12,1
James Ray ,667,5,3,1980,1981,1,-0.2
James Ray ,667,5,3,1980,1982,2,-0.3
James Ray ,667,5,3,1980,1983,3,0.2
James Robinson ,668,21,7,1993,1994,1,0.2
James Robinson ,668,21,7,1993,1995,2,1.2
James Robinson ,668,21,7,1993,1996,3,2.3
James Robinson ,668,21,7,1993,1997,4,1.9
James Robinson ,668,21,7,1993,1998,5,0.2
James Robinson ,668,21,7,1993,1999,6,-0.1
James Robinson ,668,21,7,1993,2001,8,0
James White ,669,31,3,2006,2007,1,0.3
James White ,669,31,3,2006,2009,3,0
James White ,669,31,3,2006,2013,7,0.5
James Wilkes ,670,50,3,1980,1981,1,0.8
James Wilkes ,670,50,3,1980,1982,2,1.1
James Wilkes ,670,50,3,1980,1983,3,0.1
James Young ,671,17,2,2014,2015,1,0.3
James Young ,671,17,2,2014,2016,2,0.1
Jamie Feick ,672,48,5,1996,1997,1,0.2
Jamie Feick ,672,48,5,1996,1998,2,0.9
Jamie Feick ,672,48,5,1996,1999,3,2.2
Jamie Feick ,672,48,5,1996,2000,4,4.8
Jamie Feick ,672,48,5,1996,2001,5,0.2
Jamie Waller ,673,48,1,1987,1988,1,-0.2
Jamie Watson ,674,47,4,1994,1995,1,0.8
Jamie Watson ,674,47,4,1994,1996,2,0.1
Jamie Watson ,674,47,4,1994,1997,3,0.3
Jamie Watson ,674,47,4,1994,1999,5,0
Jamison Brewer ,675,40,4,2001,2002,1,0
Jamison Brewer ,675,40,4,2001,2003,2,0.2
Jamison Brewer ,675,40,4,2001,2004,3,0
Jamison Brewer ,675,40,4,2001,2005,4,-0.3
Jan Vesely ,676,6,3,2011,2012,1,1.7
Jan Vesely ,676,6,3,2011,2013,2,0.7
Jan Vesely ,676,6,3,2011,2014,3,1.6
Jared Cunningham ,677,24,4,2012,2013,1,0
Jared Cunningham ,677,24,4,2012,2014,2,0.1
Jared Cunningham ,677,24,4,2012,2015,3,0
Jared Cunningham ,677,24,4,2012,2016,4,0.1
Jared Dudley ,678,22,9,2007,2008,1,2.9
Jared Dudley ,678,22,9,2007,2009,2,2.7
Jared Dudley ,678,22,9,2007,2010,3,5.3
Jared Dudley ,678,22,9,2007,2011,4,5.6
Jared Dudley ,678,22,9,2007,2012,5,5.1
Jared Dudley ,678,22,9,2007,2013,6,4.8
Jared Dudley ,678,22,9,2007,2014,7,2.4
Jared Dudley ,678,22,9,2007,2015,8,4.1
Jared Dudley ,678,22,9,2007,2016,9,4.6
Jared Jeffries ,679,11,11,2002,2003,1,0.3
Jared Jeffries ,679,11,11,2002,2004,2,0.6
Jared Jeffries ,679,11,11,2002,2005,3,2.6
Jared Jeffries ,679,11,11,2002,2006,4,3.1
Jared Jeffries ,679,11,11,2002,2007,5,1.2
Jared Jeffries ,679,11,11,2002,2008,6,0.1
Jared Jeffries ,679,11,11,2002,2009,7,1.2
Jared Jeffries ,679,11,11,2002,2010,8,2.2
Jared Jeffries ,679,11,11,2002,2011,9,0.6
Jared Jeffries ,679,11,11,2002,2012,10,1.7
Jared Jeffries ,679,11,11,2002,2013,11,-0.3
Jared Sullinger ,680,21,4,2012,2013,1,2.7
Jared Sullinger ,680,21,4,2012,2014,2,3.9
Jared Sullinger ,680,21,4,2012,2015,3,4
Jared Sullinger ,680,21,4,2012,2016,4,4.8
Jarell Martin ,681,25,1,2015,2016,1,0.8
Jarnell Stokes ,682,35,2,2014,2015,1,0.5
Jarnell Stokes ,682,35,2,2014,2016,2,0.1
Jarrett Jack ,683,22,11,2005,2006,1,1.2
Jarrett Jack ,683,22,11,2005,2007,2,4.8
Jarrett Jack ,683,22,11,2005,2008,3,3.2
Jarrett Jack ,683,22,11,2005,2009,4,4.1
Jarrett Jack ,683,22,11,2005,2010,5,4.8
Jarrett Jack ,683,22,11,2005,2011,6,2.4
Jarrett Jack ,683,22,11,2005,2012,7,3.8
Jarrett Jack ,683,22,11,2005,2013,8,5.6
Jarrett Jack ,683,22,11,2005,2014,9,2.3
Jarrett Jack ,683,22,11,2005,2015,10,2.6
Jarrett Jack ,683,22,11,2005,2016,11,0.9
Jarvis Hayes ,684,10,7,2003,2004,1,0.5
Jarvis Hayes ,684,10,7,2003,2005,2,1.7
Jarvis Hayes ,684,10,7,2003,2006,3,0.7
Jarvis Hayes ,684,10,7,2003,2007,4,1.5
Jarvis Hayes ,684,10,7,2003,2008,5,2.9
Jarvis Hayes ,684,10,7,2003,2009,6,2.1
Jarvis Hayes ,684,10,7,2003,2010,7,0.8
Jarvis Varnado ,685,41,2,2010,2013,3,-0.1
Jarvis Varnado ,685,41,2,2010,2014,4,0.8
Jason Caffey ,686,20,8,1995,1996,1,0.4
Jason Caffey ,686,20,8,1995,1997,2,3.9
Jason Caffey ,686,20,8,1995,1998,3,2.7
Jason Caffey ,686,20,8,1995,1999,4,0.5
Jason Caffey ,686,20,8,1995,2000,5,1.6
Jason Caffey ,686,20,8,1995,2001,6,3.5
Jason Caffey ,686,20,8,1995,2002,7,0.3
Jason Caffey ,686,20,8,1995,2003,8,0.6
Jason Collier ,687,15,5,2000,2001,1,0
Jason Collier ,687,15,5,2000,2002,2,0.4
Jason Collier ,687,15,5,2000,2003,3,0.3
Jason Collier ,687,15,5,2000,2004,4,1.2
Jason Collier ,687,15,5,2000,2005,5,0
Jason Collins ,688,18,13,2001,2002,1,3
Jason Collins ,688,18,13,2001,2003,2,4.7
Jason Collins ,688,18,13,2001,2004,3,4.9
Jason Collins ,688,18,13,2001,2005,4,3.9
Jason Collins ,688,18,13,2001,2006,5,2
Jason Collins ,688,18,13,2001,2007,6,0.6
Jason Collins ,688,18,13,2001,2008,7,0.1
Jason Collins ,688,18,13,2001,2009,8,-0.2
Jason Collins ,688,18,13,2001,2010,9,-0.1
Jason Collins ,688,18,13,2001,2011,10,0.6
Jason Collins ,688,18,13,2001,2012,11,0.2
Jason Collins ,688,18,13,2001,2013,12,0.4
Jason Collins ,688,18,13,2001,2014,13,0.1
Jason Hart ,689,49,9,2000,2001,1,0
Jason Hart ,689,49,9,2000,2002,2,0.3
Jason Hart ,689,49,9,2000,2004,4,1.9
Jason Hart ,689,49,9,2000,2005,5,4.8
Jason Hart ,689,49,9,2000,2006,6,0.1
Jason Hart ,689,49,9,2000,2007,7,1.5
Jason Hart ,689,49,9,2000,2008,8,0.4
Jason Hart ,689,49,9,2000,2009,9,-0.3
Jason Hart ,689,49,9,2000,2010,10,0
Jason Kapono ,690,31,9,2003,2004,1,0.5
Jason Kapono ,690,31,9,2003,2005,2,1.3
Jason Kapono ,690,31,9,2003,2006,3,1.2
Jason Kapono ,690,31,9,2003,2007,4,4.2
Jason Kapono ,690,31,9,2003,2008,5,1.9
Jason Kapono ,690,31,9,2003,2009,6,0.8
Jason Kapono ,690,31,9,2003,2010,7,0.5
Jason Kapono ,690,31,9,2003,2011,8,-0.2
Jason Kapono ,690,31,9,2003,2012,9,0.1
Jason Kidd ,691,2,19,1994,1995,1,3.7
Jason Kidd ,691,2,19,1994,1996,2,4.3
Jason Kidd ,691,2,19,1994,1997,3,4.4
Jason Kidd ,691,2,19,1994,1998,4,8
Jason Kidd ,691,2,19,1994,1999,5,8.1
Jason Kidd ,691,2,19,1994,2000,6,8.5
Jason Kidd ,691,2,19,1994,2001,7,9.6
Jason Kidd ,691,2,19,1994,2002,8,8.9
Jason Kidd ,691,2,19,1994,2003,9,11.3
Jason Kidd ,691,2,19,1994,2004,10,7.2
Jason Kidd ,691,2,19,1994,2005,11,7.2
Jason Kidd ,691,2,19,1994,2006,12,10.1
Jason Kidd ,691,2,19,1994,2007,13,9.3
Jason Kidd ,691,2,19,1994,2008,14,5.9
Jason Kidd ,691,2,19,1994,2009,15,8.5
Jason Kidd ,691,2,19,1994,2010,16,8.9
Jason Kidd ,691,2,19,1994,2011,17,6.4
Jason Kidd ,691,2,19,1994,2012,18,3
Jason Kidd ,691,2,19,1994,2013,19,5.4
Jason Lawson ,692,41,1,1997,1998,1,0.5
Jason Maxiell ,693,26,10,2005,2006,1,-0.2
Jason Maxiell ,693,26,10,2005,2007,2,1.8
Jason Maxiell ,693,26,10,2005,2008,3,6.3
Jason Maxiell ,693,26,10,2005,2009,4,4.1
Jason Maxiell ,693,26,10,2005,2010,5,2.6
Jason Maxiell ,693,26,10,2005,2011,6,0.5
Jason Maxiell ,693,26,10,2005,2012,7,1.7
Jason Maxiell ,693,26,10,2005,2013,8,1.8
Jason Maxiell ,693,26,10,2005,2014,9,0.3
Jason Maxiell ,693,26,10,2005,2015,10,1.4
Jason Richardson ,694,5,13,2001,2002,1,2.9
Jason Richardson ,694,5,13,2001,2003,2,3.7
Jason Richardson ,694,5,13,2001,2004,3,5.2
Jason Richardson ,694,5,13,2001,2005,4,5.7
Jason Richardson ,694,5,13,2001,2006,5,7.3
Jason Richardson ,694,5,13,2001,2007,6,3
Jason Richardson ,694,5,13,2001,2008,7,7.4
Jason Richardson ,694,5,13,2001,2009,8,5.8
Jason Richardson ,694,5,13,2001,2010,9,6.6
Jason Richardson ,694,5,13,2001,2011,10,6.9
Jason Richardson ,694,5,13,2001,2012,11,2.8
Jason Richardson ,694,5,13,2001,2013,12,1.4
Jason Richardson ,694,5,13,2001,2015,14,0.4
Jason Sasser ,695,41,2,1996,1997,1,0
Jason Sasser ,695,41,2,1996,1999,3,0
Jason Smith ,696,20,8,2007,2008,1,1.5
Jason Smith ,696,20,8,2007,2010,3,0.7
Jason Smith ,696,20,8,2007,2011,4,1.6
Jason Smith ,696,20,8,2007,2012,5,2.2
Jason Smith ,696,20,8,2007,2013,6,1.7
Jason Smith ,696,20,8,2007,2014,7,0.9
Jason Smith ,696,20,8,2007,2015,8,1.2
Jason Smith ,696,20,8,2007,2016,9,1.8
Jason Terry ,697,10,17,1999,2000,1,1.9
Jason Terry ,697,10,17,1999,2001,2,6.5
Jason Terry ,697,10,17,1999,2002,3,8.6
Jason Terry ,697,10,17,1999,2003,4,7.4
Jason Terry ,697,10,17,1999,2004,5,5.1
Jason Terry ,697,10,17,1999,2005,6,8.5
Jason Terry ,697,10,17,1999,2006,7,9.6
Jason Terry ,697,10,17,1999,2007,8,10.8
Jason Terry ,697,10,17,1999,2008,9,8.6
Jason Terry ,697,10,17,1999,2009,10,7.3
Jason Terry ,697,10,17,1999,2010,11,6.5
Jason Terry ,697,10,17,1999,2011,12,5.3
Jason Terry ,697,10,17,1999,2012,13,3.8
Jason Terry ,697,10,17,1999,2013,14,4
Jason Terry ,697,10,17,1999,2014,15,0.2
Jason Terry ,697,10,17,1999,2015,16,3.6
Jason Terry ,697,10,17,1999,2016,17,1.5
Jason Thompson ,698,12,8,2008,2009,1,2.7
Jason Thompson ,698,12,8,2008,2010,2,4
Jason Thompson ,698,12,8,2008,2011,3,2.9
Jason Thompson ,698,12,8,2008,2012,4,3.9
Jason Thompson ,698,12,8,2008,2013,5,3.6
Jason Thompson ,698,12,8,2008,2014,6,2.7
Jason Thompson ,698,12,8,2008,2015,7,2.4
Jason Thompson ,698,12,8,2008,2016,8,1.6
Jason Williams ,699,7,12,1998,1999,1,2.1
Jason Williams ,699,7,12,1998,2000,2,1.5
Jason Williams ,699,7,12,1998,2001,3,3.8
Jason Williams ,699,7,12,1998,2002,4,0.9
Jason Williams ,699,7,12,1998,2003,5,4.7
Jason Williams ,699,7,12,1998,2004,6,5.4
Jason Williams ,699,7,12,1998,2005,7,4.3
Jason Williams ,699,7,12,1998,2006,8,4.8
Jason Williams ,699,7,12,1998,2007,9,4.3
Jason Williams ,699,7,12,1998,2008,10,2.1
Jason Williams ,699,7,12,1998,2010,12,4.5
Jason Williams ,699,7,12,1998,2011,13,0.2
JaVale McGee ,700,18,8,2008,2009,1,2
JaVale McGee ,700,18,8,2008,2010,2,2.1
JaVale McGee ,700,18,8,2008,2011,3,5.3
JaVale McGee ,700,18,8,2008,2012,4,4.1
JaVale McGee ,700,18,8,2008,2013,5,4.9
JaVale McGee ,700,18,8,2008,2014,6,-0.1
JaVale McGee ,700,18,8,2008,2015,7,0.4
JaVale McGee ,700,18,8,2008,2016,8,1.1
Javaris Crittenton ,701,19,2,2007,2008,1,0.1
Javaris Crittenton ,701,19,2,2007,2009,2,0
Jawann Oldham ,702,41,10,1980,1981,1,0
Jawann Oldham ,702,41,10,1980,1982,2,0
Jawann Oldham ,702,41,10,1980,1983,3,0.3
Jawann Oldham ,702,41,10,1980,1984,4,0.5
Jawann Oldham ,702,41,10,1980,1985,5,1
Jawann Oldham ,702,41,10,1980,1986,6,1.3
Jawann Oldham ,702,41,10,1980,1987,7,0
Jawann Oldham ,702,41,10,1980,1988,8,1.2
Jawann Oldham ,702,41,10,1980,1990,10,0
Jawann Oldham ,702,41,10,1980,1991,11,0
Jay Edwards ,703,33,1,1989,1990,1,0
Jay Humphries ,704,13,11,1984,1985,1,1.9
Jay Humphries ,704,13,11,1984,1986,2,4.8
Jay Humphries ,704,13,11,1984,1987,3,4.5
Jay Humphries ,704,13,11,1984,1988,4,3.5
Jay Humphries ,704,13,11,1984,1989,5,4.9
Jay Humphries ,704,13,11,1984,1990,6,7.6
Jay Humphries ,704,13,11,1984,1991,7,8.6
Jay Humphries ,704,13,11,1984,1992,8,5.8
Jay Humphries ,704,13,11,1984,1993,9,1.8
Jay Humphries ,704,13,11,1984,1994,10,2
Jay Humphries ,704,13,11,1984,1995,11,-0.4
Jay Murphy ,705,31,4,1984,1985,1,-0.5
Jay Murphy ,705,31,4,1984,1986,2,-0.1
Jay Murphy ,705,31,4,1984,1987,3,0.2
Jay Murphy ,705,31,4,1984,1988,4,-0.1
Jay Vincent ,706,24,9,1981,1982,1,5.6
Jay Vincent ,706,24,9,1981,1983,2,6
Jay Vincent ,706,24,9,1981,1984,3,1.1
Jay Vincent ,706,24,9,1981,1985,4,6.5
Jay Vincent ,706,24,9,1981,1986,5,3.4
Jay Vincent ,706,24,9,1981,1987,6,1.9
Jay Vincent ,706,24,9,1981,1988,7,2.8
Jay Vincent ,706,24,9,1981,1989,8,-0.3
Jay Vincent ,706,24,9,1981,1990,9,0.5
Jay Williams ,707,2,1,2002,2003,1,0.8
Jayson Williams ,708,21,9,1990,1991,1,0.1
Jayson Williams ,708,21,9,1990,1992,2,-0.3
Jayson Williams ,708,21,9,1990,1993,3,0.2
Jayson Williams ,708,21,9,1990,1994,4,1.8
Jayson Williams ,708,21,9,1990,1995,5,2.1
Jayson Williams ,708,21,9,1990,1996,6,3.8
Jayson Williams ,708,21,9,1990,1997,7,1.7
Jayson Williams ,708,21,9,1990,1998,8,8.4
Jayson Williams ,708,21,9,1990,1999,9,2.2
Jeff Cook ,709,49,8,1978,1980,2,2.4
Jeff Cook ,709,49,8,1978,1981,3,4.5
Jeff Cook ,709,49,8,1978,1982,4,2
Jeff Cook ,709,49,8,1978,1983,5,2.2
Jeff Cook ,709,49,8,1978,1984,6,3.7
Jeff Cook ,709,49,8,1978,1985,7,2.3
Jeff Cook ,709,49,8,1978,1986,8,0.6
Jeff Cook ,709,49,8,1978,1988,10,0.1
Jeff Foster ,710,21,13,1999,2000,1,0.6
Jeff Foster ,710,21,13,1999,2001,2,2.7
Jeff Foster ,710,21,13,1999,2002,3,4.2
Jeff Foster ,710,21,13,1999,2003,4,1.6
Jeff Foster ,710,21,13,1999,2004,5,8.3
Jeff Foster ,710,21,13,1999,2005,6,5.4
Jeff Foster ,710,21,13,1999,2006,7,5.7
Jeff Foster ,710,21,13,1999,2007,8,4.5
Jeff Foster ,710,21,13,1999,2008,9,6.5
Jeff Foster ,710,21,13,1999,2009,10,4.2
Jeff Foster ,710,21,13,1999,2010,11,0.4
Jeff Foster ,710,21,13,1999,2011,12,3
Jeff Foster ,710,21,13,1999,2012,13,0.4
Jeff Grayer ,711,13,9,1988,1989,1,0.2
Jeff Grayer ,711,13,9,1988,1990,2,1.5
Jeff Grayer ,711,13,9,1988,1991,3,1.5
Jeff Grayer ,711,13,9,1988,1992,4,1.8
Jeff Grayer ,711,13,9,1988,1993,5,1.5
Jeff Grayer ,711,13,9,1988,1994,6,1.9
Jeff Grayer ,711,13,9,1988,1995,7,0.4
Jeff Grayer ,711,13,9,1988,1997,9,0.3
Jeff Grayer ,711,13,9,1988,1998,10,-0.1
Jeff Green ,712,5,8,2007,2008,1,0.2
Jeff Green ,712,5,8,2007,2009,2,4.2
Jeff Green ,712,5,8,2007,2010,3,6.6
Jeff Green ,712,5,8,2007,2011,4,4.8
Jeff Green ,712,5,8,2007,2013,6,4.7
Jeff Green ,712,5,8,2007,2014,7,3.3
Jeff Green ,712,5,8,2007,2015,8,5.2
Jeff Green ,712,5,8,2007,2016,9,3.1
Jeff Hornacek ,713,46,14,1986,1987,1,1.2
Jeff Hornacek ,713,46,14,1986,1988,2,5
Jeff Hornacek ,713,46,14,1986,1989,3,7.7
Jeff Hornacek ,713,46,14,1986,1990,4,8.7
Jeff Hornacek ,713,46,14,1986,1991,5,9.7
Jeff Hornacek ,713,46,14,1986,1992,6,11.6
Jeff Hornacek ,713,46,14,1986,1993,7,6.3
Jeff Hornacek ,713,46,14,1986,1994,8,6.9
Jeff Hornacek ,713,46,14,1986,1995,9,10.1
Jeff Hornacek ,713,46,14,1986,1996,10,10.2
Jeff Hornacek ,713,46,14,1986,1997,11,10.2
Jeff Hornacek ,713,46,14,1986,1998,12,9.5
Jeff Hornacek ,713,46,14,1986,1999,13,5.3
Jeff Hornacek ,713,46,14,1986,2000,14,6.5
Jeff Judkins ,714,30,5,1978,1979,1,3
Jeff Judkins ,714,30,5,1978,1980,2,1.8
Jeff Judkins ,714,30,5,1978,1981,3,0.7
Jeff Judkins ,714,30,5,1978,1982,4,0.2
Jeff Judkins ,714,30,5,1978,1983,5,0.6
Jeff Lamp ,715,15,6,1981,1982,1,0.6
Jeff Lamp ,715,15,6,1981,1983,2,0.7
Jeff Lamp ,715,15,6,1981,1984,3,1
Jeff Lamp ,715,15,6,1981,1986,5,3
Jeff Lamp ,715,15,6,1981,1988,7,0
Jeff Lamp ,715,15,6,1981,1989,8,-0.1
Jeff Malone ,716,10,13,1983,1984,1,1.3
Jeff Malone ,716,10,13,1983,1985,2,5.7
Jeff Malone ,716,10,13,1983,1986,3,6.1
Jeff Malone ,716,10,13,1983,1987,4,5.6
Jeff Malone ,716,10,13,1983,1988,5,5.6
Jeff Malone ,716,10,13,1983,1989,6,4.1
Jeff Malone ,716,10,13,1983,1990,7,5.2
Jeff Malone ,716,10,13,1983,1991,8,5.1
Jeff Malone ,716,10,13,1983,1992,9,6.6
Jeff Malone ,716,10,13,1983,1993,10,3.6
Jeff Malone ,716,10,13,1983,1994,11,4.2
Jeff Malone ,716,10,13,1983,1995,12,1.3
Jeff Malone ,716,10,13,1983,1996,13,-0.2
Jeff Martin ,717,31,2,1989,1990,1,0.9
Jeff Martin ,717,31,2,1989,1991,2,1.3
Jeff McInnis ,718,37,11,1996,1997,1,0.1
Jeff McInnis ,718,37,11,1996,1999,3,0.2
Jeff McInnis ,718,37,11,1996,2000,4,0.3
Jeff McInnis ,718,37,11,1996,2001,5,6.9
Jeff McInnis ,718,37,11,1996,2002,6,5.1
Jeff McInnis ,718,37,11,1996,2003,7,1.1
Jeff McInnis ,718,37,11,1996,2004,8,4.9
Jeff McInnis ,718,37,11,1996,2005,9,4.1
Jeff McInnis ,718,37,11,1996,2006,10,0.3
Jeff McInnis ,718,37,11,1996,2007,11,-0.1
Jeff McInnis ,718,37,11,1996,2008,12,0.1
Jeff Ruland ,719,25,8,1980,1982,2,7.8
Jeff Ruland ,719,25,8,1980,1983,3,10.1
Jeff Ruland ,719,25,8,1980,1984,4,9.3
Jeff Ruland ,719,25,8,1980,1985,5,3.3
Jeff Ruland ,719,25,8,1980,1986,6,3.5
Jeff Ruland ,719,25,8,1980,1987,7,0.3
Jeff Ruland ,719,25,8,1980,1992,12,0
Jeff Ruland ,719,25,8,1980,1993,13,0
Jeff Sanders ,720,20,4,1989,1990,1,-0.3
Jeff Sanders ,720,20,4,1989,1991,2,0
Jeff Sanders ,720,20,4,1989,1992,3,0.2
Jeff Sanders ,720,20,4,1989,1993,4,-0.1
Jeff Taylor ,721,42,2,1982,1983,1,-0.2
Jeff Taylor Jr. ,722,31,3,2012,2013,1,1.2
Jeff Taylor Jr. ,722,31,3,2012,2014,2,-0.2
Jeff Taylor Jr. ,722,31,3,2012,2015,3,0.3
Jeff Teague ,723,19,7,2009,2010,1,0.6
Jeff Teague ,723,19,7,2009,2011,2,1.7
Jeff Teague ,723,19,7,2009,2012,3,6
Jeff Teague ,723,19,7,2009,2013,4,6.1
Jeff Teague ,723,19,7,2009,2014,5,5.2
Jeff Teague ,723,19,7,2009,2015,6,7.7
Jeff Teague ,723,19,7,2009,2016,7,5.9
Jeff Trepagnier ,724,35,3,2001,2002,1,-0.2
Jeff Trepagnier ,724,35,3,2001,2003,2,0.2
Jeff Trepagnier ,724,35,3,2001,2004,3,-0.2
Jeff Turner ,725,17,10,1984,1985,1,1.2
Jeff Turner ,725,17,10,1984,1986,2,0.8
Jeff Turner ,725,17,10,1984,1987,3,0.6
Jeff Turner ,725,17,10,1984,1990,6,-0.2
Jeff Turner ,725,17,10,1984,1991,7,1.2
Jeff Turner ,725,17,10,1984,1992,8,-0.2
Jeff Turner ,725,17,10,1984,1993,9,3.1
Jeff Turner ,725,17,10,1984,1994,10,1.4
Jeff Turner ,725,17,10,1984,1995,11,1.1
Jeff Turner ,725,17,10,1984,1996,12,-0.1
Jeff Webster ,726,40,1,1994,1996,2,0
Jeff Withey ,727,39,3,2013,2014,1,1.8
Jeff Withey ,727,39,3,2013,2015,2,0.8
Jeff Withey ,727,39,3,2013,2016,3,2.3
Jelani McCoy ,728,33,8,1998,1999,1,1.4
Jelani McCoy ,728,33,8,1998,2000,2,1.5
Jelani McCoy ,728,33,8,1998,2001,3,1.1
Jelani McCoy ,728,33,8,1998,2002,4,0.1
Jelani McCoy ,728,33,8,1998,2003,5,1
Jelani McCoy ,728,33,8,1998,2004,6,0
Jelani McCoy ,728,33,8,1998,2005,7,0
Jelani McCoy ,728,33,8,1998,2008,10,0
Jerald Honeycutt ,729,38,2,1997,1998,1,0.3
Jerald Honeycutt ,729,38,2,1997,1999,2,-0.1
Jerami Grant ,730,39,2,2014,2015,1,0.5
Jerami Grant ,730,39,2,2014,2016,2,2.1
Jeremy Lamb ,731,12,4,2012,2013,1,0.2
Jeremy Lamb ,731,12,4,2012,2014,2,3.3
Jeremy Lamb ,731,12,4,2012,2015,3,1.6
Jeremy Lamb ,731,12,4,2012,2016,4,2.7
Jeremy Tyler ,732,39,3,2011,2012,1,-0.2
Jeremy Tyler ,732,39,3,2011,2013,2,-0.1
Jeremy Tyler ,732,39,3,2011,2014,3,0.5
Jerian Grant ,733,19,1,2015,2016,1,0.8
Jermaine O'Neal ,734,17,18,1996,1997,1,0.8
Jermaine O'Neal ,734,17,18,1996,1998,2,1.2
Jermaine O'Neal ,734,17,18,1996,1999,3,0.8
Jermaine O'Neal ,734,17,18,1996,2000,4,2.1
Jermaine O'Neal ,734,17,18,1996,2001,5,6.4
Jermaine O'Neal ,734,17,18,1996,2002,6,6.4
Jermaine O'Neal ,734,17,18,1996,2003,7,10.5
Jermaine O'Neal ,734,17,18,1996,2004,8,9
Jermaine O'Neal ,734,17,18,1996,2005,9,3.8
Jermaine O'Neal ,734,17,18,1996,2006,10,4.9
Jermaine O'Neal ,734,17,18,1996,2007,11,4.7
Jermaine O'Neal ,734,17,18,1996,2008,12,0.9
Jermaine O'Neal ,734,17,18,1996,2009,13,2.6
Jermaine O'Neal ,734,17,18,1996,2010,14,5.6
Jermaine O'Neal ,734,17,18,1996,2011,15,0.6
Jermaine O'Neal ,734,17,18,1996,2012,16,1.1
Jermaine O'Neal ,734,17,18,1996,2013,17,2
Jermaine O'Neal ,734,17,18,1996,2014,18,2.7
Jermaine Taylor ,735,32,2,2009,2010,1,0.1
Jermaine Taylor ,735,32,2,2009,2011,2,0.1
Jermareo Davidson ,736,36,2,2007,2008,1,-0.1
Jermareo Davidson ,736,36,2,2007,2009,2,0.1
Jerome Allen ,737,49,2,1995,1996,1,-0.3
Jerome Allen ,737,49,2,1995,1997,2,0.4
Jerome Beasley ,738,33,1,2003,2004,1,0
Jerome James ,739,36,9,1998,1999,1,-0.1
Jerome James ,739,36,9,1998,2002,4,0.9
Jerome James ,739,36,9,1998,2003,5,0.8
Jerome James ,739,36,9,1998,2004,6,0.7
Jerome James ,739,36,9,1998,2005,7,1.2
Jerome James ,739,36,9,1998,2006,8,-0.5
Jerome James ,739,36,9,1998,2007,9,-0.2
Jerome James ,739,36,9,1998,2008,10,0.1
Jerome James ,739,36,9,1998,2009,11,0
Jerome Jordan ,740,44,2,2010,2012,2,0.5
Jerome Jordan ,740,44,2,2010,2015,5,1.2
Jerome Kersey ,741,46,17,1984,1985,1,2.2
Jerome Kersey ,741,46,17,1984,1986,2,3.6
Jerome Kersey ,741,46,17,1984,1987,3,6.4
Jerome Kersey ,741,46,17,1984,1988,4,8.6
Jerome Kersey ,741,46,17,1984,1989,5,6.8
Jerome Kersey ,741,46,17,1984,1990,6,8.8
Jerome Kersey ,741,46,17,1984,1991,7,6.7
Jerome Kersey ,741,46,17,1984,1992,8,6.8
Jerome Kersey ,741,46,17,1984,1993,9,3.4
Jerome Kersey ,741,46,17,1984,1994,10,3.2
Jerome Kersey ,741,46,17,1984,1995,11,2.5
Jerome Kersey ,741,46,17,1984,1996,12,2.4
Jerome Kersey ,741,46,17,1984,1997,13,3.8
Jerome Kersey ,741,46,17,1984,1998,14,1.2
Jerome Kersey ,741,46,17,1984,1999,15,0.6
Jerome Kersey ,741,46,17,1984,2000,16,2.1
Jerome Kersey ,741,46,17,1984,2001,17,0.5
Jerome Lane ,742,23,5,1988,1989,1,0.1
Jerome Lane ,742,23,5,1988,1990,2,1.2
Jerome Lane ,742,23,5,1988,1991,3,0.6
Jerome Lane ,742,23,5,1988,1992,4,-0.2
Jerome Lane ,742,23,5,1988,1993,5,0.5
Jerome Moiso ,743,11,5,2000,2001,1,-0.3
Jerome Moiso ,743,11,5,2000,2002,2,-0.1
Jerome Moiso ,743,11,5,2000,2003,3,1.5
Jerome Moiso ,743,11,5,2000,2004,4,0.8
Jerome Moiso ,743,11,5,2000,2005,5,0.2
Jerome Whitehead ,744,41,11,1978,1979,1,0.1
Jerome Whitehead ,744,41,11,1978,1980,2,0.2
Jerome Whitehead ,744,41,11,1978,1981,3,0.2
Jerome Whitehead ,744,41,11,1978,1982,4,5.3
Jerome Whitehead ,744,41,11,1978,1983,5,2.1
Jerome Whitehead ,744,41,11,1978,1984,6,1.5
Jerome Whitehead ,744,41,11,1978,1985,7,3.6
Jerome Whitehead ,744,41,11,1978,1986,8,0.3
Jerome Whitehead ,744,41,11,1978,1987,9,1.2
Jerome Whitehead ,744,41,11,1978,1988,10,1.6
Jerome Whitehead ,744,41,11,1978,1989,11,0.4
Jerome Williams ,745,26,9,1996,1997,1,0.2
Jerome Williams ,745,26,9,1996,1998,2,4.5
Jerome Williams ,745,26,9,1996,1999,3,4.8
Jerome Williams ,745,26,9,1996,2000,4,7.6
Jerome Williams ,745,26,9,1996,2001,5,3.5
Jerome Williams ,745,26,9,1996,2002,6,5
Jerome Williams ,745,26,9,1996,2003,7,5.4
Jerome Williams ,745,26,9,1996,2004,8,4.3
Jerome Williams ,745,26,9,1996,2005,9,2.6
Jerrod Mustaf ,746,17,4,1990,1991,1,0.4
Jerrod Mustaf ,746,17,4,1990,1992,2,0.8
Jerrod Mustaf ,746,17,4,1990,1993,3,0.5
Jerrod Mustaf ,746,17,4,1990,1994,4,0
Jerry Reynolds ,747,22,8,1985,1986,1,1
Jerry Reynolds ,747,22,8,1985,1987,2,0.9
Jerry Reynolds ,747,22,8,1985,1988,3,1.3
Jerry Reynolds ,747,22,8,1985,1989,4,1.6
Jerry Reynolds ,747,22,8,1985,1990,5,1.3
Jerry Reynolds ,747,22,8,1985,1991,6,3.7
Jerry Reynolds ,747,22,8,1985,1992,7,0.6
Jerry Reynolds ,747,22,8,1985,1996,11,0
Jerry Stackhouse ,748,3,18,1995,1996,1,1.2
Jerry Stackhouse ,748,3,18,1995,1997,2,2.1
Jerry Stackhouse ,748,3,18,1995,1998,3,4.7
Jerry Stackhouse ,748,3,18,1995,1999,4,1.9
Jerry Stackhouse ,748,3,18,1995,2000,5,7.3
Jerry Stackhouse ,748,3,18,1995,2001,6,9.2
Jerry Stackhouse ,748,3,18,1995,2002,7,5.8
Jerry Stackhouse ,748,3,18,1995,2003,8,6.5
Jerry Stackhouse ,748,3,18,1995,2004,9,0.2
Jerry Stackhouse ,748,3,18,1995,2005,10,3.5
Jerry Stackhouse ,748,3,18,1995,2006,11,2.4
Jerry Stackhouse ,748,3,18,1995,2007,12,4.1
Jerry Stackhouse ,748,3,18,1995,2008,13,2.3
Jerry Stackhouse ,748,3,18,1995,2009,14,-0.4
Jerry Stackhouse ,748,3,18,1995,2010,15,0.9
Jerry Stackhouse ,748,3,18,1995,2011,16,0
Jerry Stackhouse ,748,3,18,1995,2012,17,0.3
Jerry Stackhouse ,748,3,18,1995,2013,18,0.4
Jerryd Bayless ,749,11,8,2008,2009,1,0.3
Jerryd Bayless ,749,11,8,2008,2010,2,2.7
Jerryd Bayless ,749,11,8,2008,2011,3,1.6
Jerryd Bayless ,749,11,8,2008,2012,4,2
Jerryd Bayless ,749,11,8,2008,2013,5,4
Jerryd Bayless ,749,11,8,2008,2014,6,2.4
Jerryd Bayless ,749,11,8,2008,2015,7,2.4
Jerryd Bayless ,749,11,8,2008,2016,8,2.4
Jeryl Sasser ,750,22,2,2001,2002,1,-0.1
Jeryl Sasser ,750,22,2,2001,2003,2,0.8
Jim Farmer ,751,20,5,1987,1988,1,-0.4
Jim Farmer ,751,20,5,1987,1989,2,0.4
Jim Farmer ,751,20,5,1987,1990,3,0.7
Jim Farmer ,751,20,5,1987,1991,4,0.1
Jim Farmer ,751,20,5,1987,1994,7,-0.1
Jim Jackson ,752,4,14,1992,1993,1,-1.6
Jim Jackson ,752,4,14,1992,1994,2,0.6
Jim Jackson ,752,4,14,1992,1995,3,4.9
Jim Jackson ,752,4,14,1992,1996,4,5.4
Jim Jackson ,752,4,14,1992,1997,5,4.4
Jim Jackson ,752,4,14,1992,1998,6,2.5
Jim Jackson ,752,4,14,1992,1999,7,2.5
Jim Jackson ,752,4,14,1992,2000,8,2.8
Jim Jackson ,752,4,14,1992,2001,9,0.1
Jim Jackson ,752,4,14,1992,2002,10,2.8
Jim Jackson ,752,4,14,1992,2003,11,2.5
Jim Jackson ,752,4,14,1992,2004,12,6.6
Jim Jackson ,752,4,14,1992,2005,13,3.2
Jim Jackson ,752,4,14,1992,2006,14,-0.8
Jim McIlvaine ,753,32,7,1994,1995,1,0.8
Jim McIlvaine ,753,32,7,1994,1996,2,1.8
Jim McIlvaine ,753,32,7,1994,1997,3,3
Jim McIlvaine ,753,32,7,1994,1998,4,1.9
Jim McIlvaine ,753,32,7,1994,1999,5,0.3
Jim McIlvaine ,753,32,7,1994,2000,6,1.5
Jim McIlvaine ,753,32,7,1994,2001,7,0.1
Jim Paxson ,754,12,11,1979,1980,1,0.3
Jim Paxson ,754,12,11,1979,1981,2,7.7
Jim Paxson ,754,12,11,1979,1982,3,7.5
Jim Paxson ,754,12,11,1979,1983,4,10.2
Jim Paxson ,754,12,11,1979,1984,5,9.5
Jim Paxson ,754,12,11,1979,1985,6,6.5
Jim Paxson ,754,12,11,1979,1986,7,4.8
Jim Paxson ,754,12,11,1979,1987,8,3.4
Jim Paxson ,754,12,11,1979,1988,9,1.2
Jim Paxson ,754,12,11,1979,1989,10,1.3
Jim Paxson ,754,12,11,1979,1990,11,1.4
Jim Spanarkel ,755,16,5,1979,1980,1,0.4
Jim Spanarkel ,755,16,5,1979,1981,2,5.5
Jim Spanarkel ,755,16,5,1979,1982,3,5.2
Jim Spanarkel ,755,16,5,1979,1983,4,1
Jim Spanarkel ,755,16,5,1979,1984,5,0.2
Jim Thomas ,756,40,4,1983,1984,1,1.6
Jim Thomas ,756,40,4,1983,1985,2,3.5
Jim Thomas ,756,40,4,1983,1986,3,-0.1
Jim Thomas ,756,40,4,1983,1991,8,0
Jimmer Fredette ,757,10,5,2011,2012,1,0.3
Jimmer Fredette ,757,10,5,2011,2013,2,1.1
Jimmer Fredette ,757,10,5,2011,2014,3,0.8
Jimmer Fredette ,757,10,5,2011,2015,4,0.2
Jimmer Fredette ,757,10,5,2011,2016,5,0
Jimmy Butler ,758,30,5,2011,2012,1,1.1
Jimmy Butler ,758,30,5,2011,2013,2,7
Jimmy Butler ,758,30,5,2011,2014,3,7.1
Jimmy Butler ,758,30,5,2011,2015,4,11.2
Jimmy Butler ,758,30,5,2011,2016,5,9.1
Jimmy King ,759,35,2,1995,1996,1,0
Jimmy King ,759,35,2,1995,1997,2,0
Jimmy Oliver ,760,39,5,1991,1992,1,0.2
Jimmy Oliver ,760,39,5,1991,1994,3,0.2
Jimmy Oliver ,760,39,5,1991,1997,6,-0.1
Jimmy Oliver ,760,39,5,1991,1998,7,0
Jimmy Oliver ,760,39,5,1991,1999,8,0
Jiri Welsch ,761,16,4,2002,2003,1,-0.4
Jiri Welsch ,761,16,4,2002,2004,2,3.6
Jiri Welsch ,761,16,4,2002,2005,3,1.7
Jiri Welsch ,761,16,4,2002,2006,4,0.8
Joakim Noah ,762,9,9,2007,2008,1,3.8
Joakim Noah ,762,9,9,2007,2009,2,6.4
Joakim Noah ,762,9,9,2007,2010,3,6.2
Joakim Noah ,762,9,9,2007,2011,4,6.7
Joakim Noah ,762,9,9,2007,2012,5,9
Joakim Noah ,762,9,9,2007,2013,6,7.3
Joakim Noah ,762,9,9,2007,2014,7,11.2
Joakim Noah ,762,9,9,2007,2015,8,5.6
Joakim Noah ,762,9,9,2007,2016,9,1.1
Jodie Meeks ,763,41,7,2009,2010,1,0.9
Jodie Meeks ,763,41,7,2009,2011,2,5.1
Jodie Meeks ,763,41,7,2009,2012,3,4.1
Jodie Meeks ,763,41,7,2009,2013,4,3
Jodie Meeks ,763,41,7,2009,2014,5,4.5
Jodie Meeks ,763,41,7,2009,2015,6,3.1
Jodie Meeks ,763,41,7,2009,2016,7,0.1
Joe Alexander ,764,8,2,2008,2009,1,0.4
Joe Alexander ,764,8,2,2008,2010,2,0
Joe Barry Carroll ,765,1,10,1980,1981,1,5.7
Joe Barry Carroll ,765,1,10,1980,1982,2,5.5
Joe Barry Carroll ,765,1,10,1980,1983,3,7
Joe Barry Carroll ,765,1,10,1980,1984,4,4.7
Joe Barry Carroll ,765,1,10,1980,1986,6,3.4
Joe Barry Carroll ,765,1,10,1980,1987,7,4.6
Joe Barry Carroll ,765,1,10,1980,1988,8,1.6
Joe Barry Carroll ,765,1,10,1980,1989,9,2.3
Joe Barry Carroll ,765,1,10,1980,1990,10,0.7
Joe Barry Carroll ,765,1,10,1980,1991,11,0
Joe Harris ,766,33,2,2014,2015,1,0.2
Joe Harris ,766,33,2,2014,2016,2,0
Joe Johnson ,767,10,15,2001,2002,1,3
Joe Johnson ,767,10,15,2001,2003,2,2.8
Joe Johnson ,767,10,15,2001,2004,3,3.3
Joe Johnson ,767,10,15,2001,2005,4,7.6
Joe Johnson ,767,10,15,2001,2006,5,6
Joe Johnson ,767,10,15,2001,2007,6,5.1
Joe Johnson ,767,10,15,2001,2008,7,7
Joe Johnson ,767,10,15,2001,2009,8,7.6
Joe Johnson ,767,10,15,2001,2010,9,8.4
Joe Johnson ,767,10,15,2001,2011,10,4.2
Joe Johnson ,767,10,15,2001,2012,11,6.4
Joe Johnson ,767,10,15,2001,2013,12,5.1
Joe Johnson ,767,10,15,2001,2014,13,4.9
Joe Johnson ,767,10,15,2001,2015,14,4.1
Joe Johnson ,767,10,15,2001,2016,15,2.7
Joe Kleine ,768,6,15,1985,1986,1,0.9
Joe Kleine ,768,6,15,1985,1987,2,2.6
Joe Kleine ,768,6,15,1985,1988,3,3.1
Joe Kleine ,768,6,15,1985,1989,4,1
Joe Kleine ,768,6,15,1985,1990,5,2.3
Joe Kleine ,768,6,15,1985,1991,6,1.2
Joe Kleine ,768,6,15,1985,1992,7,2.6
Joe Kleine ,768,6,15,1985,1993,8,1.5
Joe Kleine ,768,6,15,1985,1994,9,1.6
Joe Kleine ,768,6,15,1985,1995,10,1.4
Joe Kleine ,768,6,15,1985,1996,11,0.1
Joe Kleine ,768,6,15,1985,1997,12,0.4
Joe Kleine ,768,6,15,1985,1998,13,0.1
Joe Kleine ,768,6,15,1985,1999,14,0.3
Joe Kleine ,768,6,15,1985,2000,15,0
Joe Smith ,769,1,16,1995,1996,1,6.8
Joe Smith ,769,1,16,1995,1997,2,4.4
Joe Smith ,769,1,16,1995,1998,3,2.6
Joe Smith ,769,1,16,1995,1999,4,3.7
Joe Smith ,769,1,16,1995,2000,5,4.7
Joe Smith ,769,1,16,1995,2001,6,4.4
Joe Smith ,769,1,16,1995,2002,7,6.1
Joe Smith ,769,1,16,1995,2003,8,3
Joe Smith ,769,1,16,1995,2004,9,6.3
Joe Smith ,769,1,16,1995,2005,10,5.5
Joe Smith ,769,1,16,1995,2006,11,2.3
Joe Smith ,769,1,16,1995,2007,12,2.8
Joe Smith ,769,1,16,1995,2008,13,4.1
Joe Smith ,769,1,16,1995,2009,14,2.7
Joe Smith ,769,1,16,1995,2010,15,0.9
Joe Smith ,769,1,16,1995,2011,16,-0.1
Joe Wolf ,770,13,11,1987,1988,1,0.1
Joe Wolf ,770,13,11,1987,1989,2,-0.5
Joe Wolf ,770,13,11,1987,1990,3,-0.2
Joe Wolf ,770,13,11,1987,1991,4,0.7
Joe Wolf ,770,13,11,1987,1992,5,0.3
Joe Wolf ,770,13,11,1987,1993,6,0.4
Joe Wolf ,770,13,11,1987,1995,8,0.9
Joe Wolf ,770,13,11,1987,1996,9,1.5
Joe Wolf ,770,13,11,1987,1997,10,0.8
Joe Wolf ,770,13,11,1987,1998,11,-0.5
Joe Wolf ,770,13,11,1987,1999,12,0
Joel Freeland ,771,30,3,2006,2013,7,0.2
Joel Freeland ,771,30,3,2006,2014,8,1.4
Joel Freeland ,771,30,3,2006,2015,9,1.6
Joel Przybilla ,772,9,13,2000,2001,1,0.1
Joel Przybilla ,772,9,13,2000,2002,2,1.9
Joel Przybilla ,772,9,13,2000,2003,3,0.6
Joel Przybilla ,772,9,13,2000,2004,4,0.1
Joel Przybilla ,772,9,13,2000,2005,5,4.7
Joel Przybilla ,772,9,13,2000,2006,6,2.3
Joel Przybilla ,772,9,13,2000,2007,7,0.3
Joel Przybilla ,772,9,13,2000,2008,8,4.3
Joel Przybilla ,772,9,13,2000,2009,9,6.6
Joel Przybilla ,772,9,13,2000,2010,10,1.4
Joel Przybilla ,772,9,13,2000,2011,11,0.5
Joel Przybilla ,772,9,13,2000,2012,12,0.3
Joel Przybilla ,772,9,13,2000,2013,13,0
Joey Dorsey ,773,33,4,2008,2009,1,0
Joey Dorsey ,773,33,4,2008,2010,2,0.1
Joey Dorsey ,773,33,4,2008,2011,3,0.8
Joey Dorsey ,773,33,4,2008,2015,7,1.9
Joey Graham ,774,16,6,2005,2006,1,1.3
Joey Graham ,774,16,6,2005,2007,2,3
Joey Graham ,774,16,6,2005,2008,3,0.3
Joey Graham ,774,16,6,2005,2009,4,2.2
Joey Graham ,774,16,6,2005,2010,5,1.1
Joey Graham ,774,16,6,2005,2011,6,0
Johan Petro ,775,25,8,2005,2006,1,1
Johan Petro ,775,25,8,2005,2007,2,1.7
Johan Petro ,775,25,8,2005,2008,3,0.4
Johan Petro ,775,25,8,2005,2009,4,0.2
Johan Petro ,775,25,8,2005,2010,5,0.8
Johan Petro ,775,25,8,2005,2011,6,0.4
Johan Petro ,775,25,8,2005,2012,7,0.7
Johan Petro ,775,25,8,2005,2013,8,0.4
John Bagley ,776,12,11,1982,1983,1,-0.2
John Bagley ,776,12,11,1982,1984,2,0.9
John Bagley ,776,12,11,1982,1985,3,4.6
John Bagley ,776,12,11,1982,1986,4,3
John Bagley ,776,12,11,1982,1987,5,2.6
John Bagley ,776,12,11,1982,1988,6,2.6
John Bagley ,776,12,11,1982,1989,7,0.4
John Bagley ,776,12,11,1982,1990,8,1.1
John Bagley ,776,12,11,1982,1992,10,1.9
John Bagley ,776,12,11,1982,1993,11,-0.3
John Bagley ,776,12,11,1982,1994,12,0
John Celestand ,777,30,1,1999,2000,1,-0.1
John Duren ,778,19,3,1980,1981,1,-0.9
John Duren ,778,19,3,1980,1982,2,-0.3
John Duren ,778,19,3,1980,1983,3,0.4
John Garris ,779,27,1,1983,1984,1,0.9
John Henson ,780,14,4,2012,2013,1,1.9
John Henson ,780,14,4,2012,2014,2,3.3
John Henson ,780,14,4,2012,2015,3,3.6
John Henson ,780,14,4,2012,2016,4,2.3
John Jenkins ,781,23,4,2012,2013,1,1.7
John Jenkins ,781,23,4,2012,2014,2,-0.1
John Jenkins ,781,23,4,2012,2015,3,0.9
John Jenkins ,781,23,4,2012,2016,4,0.2
John Long ,782,29,14,1978,1979,1,3.6
John Long ,782,29,14,1978,1980,2,3.6
John Long ,782,29,14,1978,1981,3,2.4
John Long ,782,29,14,1978,1982,4,4.7
John Long ,782,29,14,1978,1983,5,0.2
John Long ,782,29,14,1978,1984,6,5.3
John Long ,782,29,14,1978,1985,7,3.3
John Long ,782,29,14,1978,1986,8,2
John Long ,782,29,14,1978,1987,9,2.1
John Long ,782,29,14,1978,1988,10,3.9
John Long ,782,29,14,1978,1989,11,0.2
John Long ,782,29,14,1978,1990,12,0.2
John Long ,782,29,14,1978,1991,13,0.5
John Long ,782,29,14,1978,1997,19,0.1
John Morton ,783,25,3,1989,1990,1,-0.9
John Morton ,783,25,3,1989,1991,2,1.5
John Morton ,783,25,3,1989,1992,3,-0.1
John Paxson ,784,19,11,1983,1984,1,0.6
John Paxson ,784,19,11,1983,1985,2,2.3
John Paxson ,784,19,11,1983,1986,3,2.2
John Paxson ,784,19,11,1983,1987,4,6
John Paxson ,784,19,11,1983,1988,5,4.2
John Paxson ,784,19,11,1983,1989,6,3.3
John Paxson ,784,19,11,1983,1990,7,4.8
John Paxson ,784,19,11,1983,1991,8,5.7
John Paxson ,784,19,11,1983,1992,9,4.7
John Paxson ,784,19,11,1983,1993,10,1.9
John Paxson ,784,19,11,1983,1994,11,0.6
John Rudd ,785,32,1,1978,1979,1,0.6
John Salley ,786,11,11,1986,1987,1,3.8
John Salley ,786,11,11,1986,1988,2,6.2
John Salley ,786,11,11,1986,1989,3,3.5
John Salley ,786,11,11,1986,1990,4,6.1
John Salley ,786,11,11,1986,1991,5,4.8
John Salley ,786,11,11,1986,1992,6,5.1
John Salley ,786,11,11,1986,1993,7,2.5
John Salley ,786,11,11,1986,1994,8,4.8
John Salley ,786,11,11,1986,1995,9,3.6
John Salley ,786,11,11,1986,1996,10,0.6
John Salley ,786,11,11,1986,2000,14,0.5
John Salmons ,787,26,13,2002,2003,1,0.6
John Salmons ,787,26,13,2002,2004,2,2.1
John Salmons ,787,26,13,2002,2005,3,1.4
John Salmons ,787,26,13,2002,2006,4,1.7
John Salmons ,787,26,13,2002,2007,5,3.6
John Salmons ,787,26,13,2002,2008,6,3.7
John Salmons ,787,26,13,2002,2009,7,5.6
John Salmons ,787,26,13,2002,2010,8,7.1
John Salmons ,787,26,13,2002,2011,9,4.3
John Salmons ,787,26,13,2002,2012,10,0.4
John Salmons ,787,26,13,2002,2013,11,1.6
John Salmons ,787,26,13,2002,2014,12,1.7
John Salmons ,787,26,13,2002,2015,13,0.1
John Stroud ,788,27,1,1980,1981,1,-0.1
John Thomas ,789,25,5,1997,1998,1,0.4
John Thomas ,789,25,5,1997,1999,2,1.5
John Thomas ,789,25,5,1997,2000,3,0.4
John Thomas ,789,25,5,1997,2005,8,0.9
John Thomas ,789,25,5,1997,2006,9,0
John Turner ,790,20,1,1991,1992,1,-0.1
John Wall ,791,1,6,2010,2011,1,2.2
John Wall ,791,1,6,2010,2012,2,3.5
John Wall ,791,1,6,2010,2013,3,4.5
John Wall ,791,1,6,2010,2014,4,7.9
John Wall ,791,1,6,2010,2015,5,7.8
John Wall ,791,1,6,2010,2016,6,5.7
John Wallace ,792,18,7,1996,1997,1,1.6
John Wallace ,792,18,7,1996,1998,2,1.5
John Wallace ,792,18,7,1996,1999,3,1
John Wallace ,792,18,7,1996,2000,4,1
John Wallace ,792,18,7,1996,2001,5,0.3
John Wallace ,792,18,7,1996,2002,6,0.7
John Wallace ,792,18,7,1996,2004,8,0.3
John Williams ,793,12,8,1986,1987,1,3.5
John Williams ,793,12,8,1986,1988,2,5
John Williams ,793,12,8,1986,1989,3,6.9
John Williams ,793,12,8,1986,1990,4,1.3
John Williams ,793,12,8,1986,1991,5,1
John Williams ,793,12,8,1986,1993,7,1.9
John Williams ,793,12,8,1986,1994,8,0.8
John Williams ,793,12,8,1986,1995,9,-0.5
Johnny Dawkins ,794,10,9,1986,1987,1,2
Johnny Dawkins ,794,10,9,1986,1988,2,4.3
Johnny Dawkins ,794,10,9,1986,1989,3,1
Johnny Dawkins ,794,10,9,1986,1990,4,6.4
Johnny Dawkins ,794,10,9,1986,1991,5,0.6
Johnny Dawkins ,794,10,9,1986,1992,6,3.6
Johnny Dawkins ,794,10,9,1986,1993,7,1.7
Johnny Dawkins ,794,10,9,1986,1994,8,1.1
Johnny Dawkins ,794,10,9,1986,1995,9,1.1
Johnny High ,795,24,4,1979,1980,1,1.1
Johnny High ,795,24,4,1979,1981,2,2.5
Johnny High ,795,24,4,1979,1983,4,1.2
Johnny High ,795,24,4,1979,1984,5,-0.1
Johnny Moore ,796,43,9,1979,1981,2,3.2
Johnny Moore ,796,43,9,1979,1982,3,5.8
Johnny Moore ,796,43,9,1979,1983,4,6.6
Johnny Moore ,796,43,9,1979,1984,5,3.8
Johnny Moore ,796,43,9,1979,1985,6,7.2
Johnny Moore ,796,43,9,1979,1986,7,2.1
Johnny Moore ,796,43,9,1979,1987,8,1.2
Johnny Moore ,796,43,9,1979,1988,9,-0.1
Johnny Moore ,796,43,9,1979,1990,11,0.3
Johnny Newman ,797,29,16,1986,1987,1,0.3
Johnny Newman ,797,29,16,1986,1988,2,3.1
Johnny Newman ,797,29,16,1986,1989,3,6.7
Johnny Newman ,797,29,16,1986,1990,4,4.5
Johnny Newman ,797,29,16,1986,1991,5,4.1
Johnny Newman ,797,29,16,1986,1992,6,2.3
Johnny Newman ,797,29,16,1986,1993,7,3.7
Johnny Newman ,797,29,16,1986,1994,8,3.7
Johnny Newman ,797,29,16,1986,1995,9,2.8
Johnny Newman ,797,29,16,1986,1996,10,4.4
Johnny Newman ,797,29,16,1986,1997,11,2.8
Johnny Newman ,797,29,16,1986,1998,12,2.7
Johnny Newman ,797,29,16,1986,1999,13,1.2
Johnny Newman ,797,29,16,1986,2000,14,3.5
Johnny Newman ,797,29,16,1986,2001,15,3.4
Johnny Newman ,797,29,16,1986,2002,16,0.9
Johnny Rogers ,798,34,2,1986,1987,1,0.4
Johnny Rogers ,798,34,2,1986,1988,2,0
Johnny Taylor ,799,17,3,1997,1998,1,-0.1
Johnny Taylor ,799,17,3,1997,1999,2,0.2
Johnny Taylor ,799,17,3,1997,2000,3,0
Jon Barry ,800,21,14,1992,1993,1,-0.1
Jon Barry ,800,21,14,1992,1994,2,2.1
Jon Barry ,800,21,14,1992,1995,3,1.1
Jon Barry ,800,21,14,1992,1996,4,1.8
Jon Barry ,800,21,14,1992,1997,5,2.4
Jon Barry ,800,21,14,1992,1998,6,0.9
Jon Barry ,800,21,14,1992,1999,7,2.4
Jon Barry ,800,21,14,1992,2000,8,4.2
Jon Barry ,800,21,14,1992,2001,9,2.4
Jon Barry ,800,21,14,1992,2002,10,7.5
Jon Barry ,800,21,14,1992,2003,11,5.6
Jon Barry ,800,21,14,1992,2004,12,2.8
Jon Barry ,800,21,14,1992,2005,13,3.9
Jon Barry ,800,21,14,1992,2006,14,0.4
Jon Brockman ,801,38,3,2009,2010,1,1.7
Jon Brockman ,801,38,3,2009,2011,2,1.9
Jon Brockman ,801,38,3,2009,2012,3,0.1
Jon Koncak ,802,5,11,1985,1986,1,3.7
Jon Koncak ,802,5,11,1985,1987,2,3.7
Jon Koncak ,802,5,11,1985,1988,3,2.3
Jon Koncak ,802,5,11,1985,1989,4,3.7
Jon Koncak ,802,5,11,1985,1990,5,1.4
Jon Koncak ,802,5,11,1985,1991,6,2.5
Jon Koncak ,802,5,11,1985,1992,7,1.1
Jon Koncak ,802,5,11,1985,1993,8,3.1
Jon Koncak ,802,5,11,1985,1994,9,3.8
Jon Koncak ,802,5,11,1985,1995,10,1.8
Jon Koncak ,802,5,11,1985,1996,11,2
Jon Leuer ,803,40,5,2011,2012,1,1.4
Jon Leuer ,803,40,5,2011,2013,2,0.2
Jon Leuer ,803,40,5,2011,2014,3,2
Jon Leuer ,803,40,5,2011,2015,4,1.3
Jon Leuer ,803,40,5,2011,2016,5,2.7
Jon Sundvold ,804,16,9,1983,1984,1,1.2
Jon Sundvold ,804,16,9,1983,1985,2,0.2
Jon Sundvold ,804,16,9,1983,1986,3,1.5
Jon Sundvold ,804,16,9,1983,1987,4,3
Jon Sundvold ,804,16,9,1983,1988,5,1
Jon Sundvold ,804,16,9,1983,1989,6,1
Jon Sundvold ,804,16,9,1983,1990,7,0.8
Jon Sundvold ,804,16,9,1983,1991,8,0.2
Jon Sundvold ,804,16,9,1983,1992,9,0
Jonas Jerebko ,805,39,6,2009,2010,1,4.4
Jonas Jerebko ,805,39,6,2009,2012,3,3.3
Jonas Jerebko ,805,39,6,2009,2013,4,2
Jonas Jerebko ,805,39,6,2009,2014,5,1.4
Jonas Jerebko ,805,39,6,2009,2015,6,3.5
Jonas Jerebko ,805,39,6,2009,2016,7,2.4
Jonas Valanciunas ,806,5,4,2011,2013,2,3.9
Jonas Valanciunas ,806,5,4,2011,2014,3,6.7
Jonas Valanciunas ,806,5,4,2011,2015,4,8.2
Jonas Valanciunas ,806,5,4,2011,2016,5,6.9
Jonathan Bender ,807,5,8,1999,2000,1,-0.2
Jonathan Bender ,807,5,8,1999,2001,2,-0.1
Jonathan Bender ,807,5,8,1999,2002,3,2
Jonathan Bender ,807,5,8,1999,2003,4,1.7
Jonathan Bender ,807,5,8,1999,2004,5,0.5
Jonathan Bender ,807,5,8,1999,2005,6,-0.2
Jonathan Bender ,807,5,8,1999,2006,7,0.2
Jonathan Bender ,807,5,8,1999,2010,11,0
Jonny Flynn ,808,6,3,2009,2010,1,0.1
Jonny Flynn ,808,6,3,2009,2011,2,-1.3
Jonny Flynn ,808,6,3,2009,2012,3,0.1
Jordan Adams ,809,22,2,2014,2015,1,0.4
Jordan Adams ,809,22,2,2014,2016,2,0
Jordan Clarkson ,810,46,2,2014,2015,1,2.4
Jordan Clarkson ,810,46,2,2014,2016,2,2.1
Jordan Crawford ,811,27,4,2010,2011,1,-0.6
Jordan Crawford ,811,27,4,2010,2012,2,1.1
Jordan Crawford ,811,27,4,2010,2013,3,1.9
Jordan Crawford ,811,27,4,2010,2014,4,2.8
Jordan Farmar ,812,26,9,2006,2007,1,0.9
Jordan Farmar ,812,26,9,2006,2008,2,3.9
Jordan Farmar ,812,26,9,2006,2009,3,0.8
Jordan Farmar ,812,26,9,2006,2010,4,2.8
Jordan Farmar ,812,26,9,2006,2011,5,1.9
Jordan Farmar ,812,26,9,2006,2012,6,1.8
Jordan Farmar ,812,26,9,2006,2014,8,0.7
Jordan Farmar ,812,26,9,2006,2015,9,0.6
Jordan Farmar ,812,26,9,2006,2016,10,0.4
Jordan Hamilton ,813,26,5,2011,2012,1,0.3
Jordan Hamilton ,813,26,5,2011,2013,2,0.8
Jordan Hamilton ,813,26,5,2011,2014,3,1.6
Jordan Hamilton ,813,26,5,2011,2015,4,0.1
Jordan Hamilton ,813,26,5,2011,2016,5,0.2
Jordan Hill ,814,8,7,2009,2010,1,1.4
Jordan Hill ,814,8,7,2009,2011,2,1.8
Jordan Hill ,814,8,7,2009,2012,3,1.4
Jordan Hill ,814,8,7,2009,2013,4,1.4
Jordan Hill ,814,8,7,2009,2014,5,4.4
Jordan Hill ,814,8,7,2009,2015,6,2.2
Jordan Hill ,814,8,7,2009,2016,7,3.9
Jordan Mickey ,815,33,1,2015,2016,1,0.1
Jordan Williams ,816,36,1,2011,2012,1,1.3
Jose Ortiz ,817,15,2,1987,1989,2,-0.1
Jose Ortiz ,817,15,2,1987,1990,3,0.1
Jose Slaughter ,818,43,1,1982,1983,1,-0.1
Joseph Forte ,819,21,2,2001,2002,1,-0.1
Joseph Forte ,819,21,2,2001,2003,2,-0.3
Joseph Young ,820,43,1,2015,2016,1,-0.1
Josh Boone ,821,23,4,2006,2007,1,1.7
Josh Boone ,821,23,4,2006,2008,2,3.7
Josh Boone ,821,23,4,2006,2009,3,1.8
Josh Boone ,821,23,4,2006,2010,4,1.8
Josh Childress ,822,6,8,2004,2005,1,4.6
Josh Childress ,822,6,8,2004,2006,2,5.7
Josh Childress ,822,6,8,2004,2007,3,5.5
Josh Childress ,822,6,8,2004,2008,4,7.6
Josh Childress ,822,6,8,2004,2011,7,1.4
Josh Childress ,822,6,8,2004,2012,8,0.9
Josh Childress ,822,6,8,2004,2013,9,0.1
Josh Childress ,822,6,8,2004,2014,10,0
Josh Grant ,823,43,1,1993,1994,1,0.5
Josh Harrellson ,824,45,3,2011,2012,1,1.4
Josh Harrellson ,824,45,3,2011,2013,2,0
Josh Harrellson ,824,45,3,2011,2014,3,0.7
Josh Howard ,825,29,10,2003,2004,1,3.5
Josh Howard ,825,29,10,2003,2005,2,6.4
Josh Howard ,825,29,10,2003,2006,3,6.7
Josh Howard ,825,29,10,2003,2007,4,8.8
Josh Howard ,825,29,10,2003,2008,5,8
Josh Howard ,825,29,10,2003,2009,6,3.2
Josh Howard ,825,29,10,2003,2010,7,1
Josh Howard ,825,29,10,2003,2011,8,-0.2
Josh Howard ,825,29,10,2003,2012,9,0.5
Josh Howard ,825,29,10,2003,2013,10,0
Josh Huestis ,826,29,1,2014,2016,2,0
Josh McRoberts ,827,37,9,2007,2008,1,0.1
Josh McRoberts ,827,37,9,2007,2009,2,0.4
Josh McRoberts ,827,37,9,2007,2010,3,1.5
Josh McRoberts ,827,37,9,2007,2011,4,4.9
Josh McRoberts ,827,37,9,2007,2012,5,1.4
Josh McRoberts ,827,37,9,2007,2013,6,2.2
Josh McRoberts ,827,37,9,2007,2014,7,6.5
Josh McRoberts ,827,37,9,2007,2015,8,0.4
Josh McRoberts ,827,37,9,2007,2016,9,0.8
Josh Richardson ,828,40,1,2015,2016,1,2.5
Josh Selby ,829,49,2,2011,2012,1,-0.5
Josh Selby ,829,49,2,2011,2013,2,-0.2
Josh Smith ,830,17,12,2004,2005,1,2.4
Josh Smith ,830,17,12,2004,2006,2,3.6
Josh Smith ,830,17,12,2004,2007,3,4.4
Josh Smith ,830,17,12,2004,2008,4,5.8
Josh Smith ,830,17,12,2004,2009,5,4.9
Josh Smith ,830,17,12,2004,2010,6,9.3
Josh Smith ,830,17,12,2004,2011,7,6.4
Josh Smith ,830,17,12,2004,2012,8,6.8
Josh Smith ,830,17,12,2004,2013,9,4.2
Josh Smith ,830,17,12,2004,2014,10,1.1
Josh Smith ,830,17,12,2004,2015,11,2.3
Josh Smith ,830,17,12,2004,2016,12,0
Jrue Holiday ,831,17,7,2009,2010,1,1.2
Jrue Holiday ,831,17,7,2009,2011,2,5.7
Jrue Holiday ,831,17,7,2009,2012,3,4.2
Jrue Holiday ,831,17,7,2009,2013,4,3.3
Jrue Holiday ,831,17,7,2009,2014,5,1.5
Jrue Holiday ,831,17,7,2009,2015,6,3.4
Jrue Holiday ,831,17,7,2009,2016,7,3.4
Juan Carlos Navarro ,832,39,1,2002,2008,6,1.4
Juan Dixon ,833,17,7,2002,2003,1,0.1
Juan Dixon ,833,17,7,2002,2004,2,1.4
Juan Dixon ,833,17,7,2002,2005,3,2
Juan Dixon ,833,17,7,2002,2006,4,1.2
Juan Dixon ,833,17,7,2002,2007,5,1.7
Juan Dixon ,833,17,7,2002,2008,6,0.4
Juan Dixon ,833,17,7,2002,2009,7,-0.5
Jud Buechler ,834,38,12,1990,1991,1,1.2
Jud Buechler ,834,38,12,1990,1992,2,0.4
Jud Buechler ,834,38,12,1990,1993,3,1.8
Jud Buechler ,834,38,12,1990,1994,4,0.5
Jud Buechler ,834,38,12,1990,1995,5,1.5
Jud Buechler ,834,38,12,1990,1996,6,2.3
Jud Buechler ,834,38,12,1990,1997,7,1.2
Jud Buechler ,834,38,12,1990,1998,8,1.9
Jud Buechler ,834,38,12,1990,1999,9,2.9
Jud Buechler ,834,38,12,1990,2000,10,0.5
Jud Buechler ,834,38,12,1990,2001,11,1.5
Jud Buechler ,834,38,12,1990,2002,12,0.8
Julian Wright ,835,13,4,2007,2008,1,1.7
Julian Wright ,835,13,4,2007,2009,2,0.8
Julian Wright ,835,13,4,2007,2010,3,0.8
Julian Wright ,835,13,4,2007,2011,4,0.6
Julius Hodge ,836,20,2,2005,2006,1,-0.2
Julius Hodge ,836,20,2,2005,2007,2,0.2
Julius Randle ,837,7,2,2014,2015,1,-0.1
Julius Randle ,837,7,2,2014,2016,2,1.6
Jumaine Jones ,838,27,8,1999,2000,1,0
Jumaine Jones ,838,27,8,1999,2001,2,2.3
Jumaine Jones ,838,27,8,1999,2002,3,3.3
Jumaine Jones ,838,27,8,1999,2003,4,2.9
Jumaine Jones ,838,27,8,1999,2004,5,0.1
Jumaine Jones ,838,27,8,1999,2005,6,3.7
Jumaine Jones ,838,27,8,1999,2006,7,3
Jumaine Jones ,838,27,8,1999,2007,8,-0.2
Junior Burrough ,839,33,1,1995,1996,1,-0.2
Justin Anderson ,840,21,1,2015,2016,1,1.1
Justin Hamilton ,841,45,2,2012,2014,2,0.1
Justin Hamilton ,841,45,2,2012,2015,3,1.5
Justin Harper ,842,32,2,2011,2012,1,-0.3
Justin Harper ,842,32,2,2011,2016,5,0
Justin Reed ,843,40,3,2004,2005,1,0.3
Justin Reed ,843,40,3,2004,2006,2,0.4
Justin Reed ,843,40,3,2004,2007,3,-0.2
Justise Winslow ,844,10,1,2015,2016,1,2.5
Jusuf Nurkic ,845,16,2,2014,2015,1,1.6
Jusuf Nurkic ,845,16,2,2014,2016,2,0.4
Juwan Howard ,846,5,19,1994,1995,1,2.8
Juwan Howard ,846,5,19,1994,1996,2,5.6
Juwan Howard ,846,5,19,1994,1997,3,7
Juwan Howard ,846,5,19,1994,1998,4,4.6
Juwan Howard ,846,5,19,1994,1999,5,2.8
Juwan Howard ,846,5,19,1994,2000,6,1.9
Juwan Howard ,846,5,19,1994,2001,7,4.4
Juwan Howard ,846,5,19,1994,2002,8,4.9
Juwan Howard ,846,5,19,1994,2003,9,6
Juwan Howard ,846,5,19,1994,2004,10,3.6
Juwan Howard ,846,5,19,1994,2005,11,3.2
Juwan Howard ,846,5,19,1994,2006,12,3.7
Juwan Howard ,846,5,19,1994,2007,13,4.9
Juwan Howard ,846,5,19,1994,2008,14,0.1
Juwan Howard ,846,5,19,1994,2009,15,0.7
Juwan Howard ,846,5,19,1994,2010,16,2.6
Juwan Howard ,846,5,19,1994,2011,17,0.9
Juwan Howard ,846,5,19,1994,2012,18,-0.3
Juwan Howard ,846,5,19,1994,2013,19,0
K.J. McDaniels ,847,32,2,2014,2015,1,0.6
K.J. McDaniels ,847,32,2,2014,2016,2,0.2
Kaniel Dickens ,848,50,3,2000,2004,4,0
Kaniel Dickens ,848,50,3,2000,2005,5,0
Kaniel Dickens ,848,50,3,2000,2008,8,0
Kannard Johnson ,849,41,1,1987,1988,1,-0.1
Kareem Rush ,850,20,7,2002,2003,1,-0.6
Kareem Rush ,850,20,7,2002,2004,2,1.5
Kareem Rush ,850,20,7,2002,2005,3,0.1
Kareem Rush ,850,20,7,2002,2006,4,-0.2
Kareem Rush ,850,20,7,2002,2008,6,1
Kareem Rush ,850,20,7,2002,2009,7,0
Kareem Rush ,850,20,7,2002,2010,8,0
Karl-Anthony Towns ,851,1,1,2015,2016,1,8.3
Kawhi Leonard ,852,15,5,2011,2012,1,5.5
Kawhi Leonard ,852,15,5,2011,2013,2,6.2
Kawhi Leonard ,852,15,5,2011,2014,3,7.7
Kawhi Leonard ,852,15,5,2011,2015,4,8.6
Kawhi Leonard ,852,15,5,2011,2016,5,13.7
Kebu Stewart ,853,35,1,1997,1998,1,0.2
Kedrick Brown ,854,11,4,2001,2002,1,0.4
Kedrick Brown ,854,11,4,2001,2003,2,0.5
Kedrick Brown ,854,11,4,2001,2004,3,2
Kedrick Brown ,854,11,4,2001,2005,4,0.1
Keith Benson ,855,48,1,2011,2012,1,0
Keith Bogans ,856,43,11,2003,2004,1,1.3
Keith Bogans ,856,43,11,2003,2005,2,0.1
Keith Bogans ,856,43,11,2003,2006,3,2.3
Keith Bogans ,856,43,11,2003,2007,4,1.7
Keith Bogans ,856,43,11,2003,2008,5,4.9
Keith Bogans ,856,43,11,2003,2009,6,2.5
Keith Bogans ,856,43,11,2003,2010,7,2.6
Keith Bogans ,856,43,11,2003,2011,8,3.6
Keith Bogans ,856,43,11,2003,2012,9,0
Keith Bogans ,856,43,11,2003,2013,10,1.4
Keith Bogans ,856,43,11,2003,2014,11,0.1
Keith Booth ,857,28,2,1997,1998,1,0
Keith Booth ,857,28,2,1997,1999,2,-0.8
Keith Edmonson ,858,10,2,1982,1983,1,-0.3
Keith Edmonson ,858,10,2,1982,1984,2,0.7
Keith Herron ,859,24,3,1978,1979,1,0
Keith Herron ,859,24,3,1978,1981,3,3.5
Keith Herron ,859,24,3,1978,1982,4,-0.3
Keith Lee ,860,11,3,1985,1986,1,1.9
Keith Lee ,860,11,3,1985,1987,2,1.1
Keith Lee ,860,11,3,1985,1989,4,0.8
Keith Smart ,861,41,1,1988,1989,1,0
Keith Smith ,862,45,1,1986,1987,1,0
Keith Van Horn ,863,2,9,1997,1998,1,4.8
Keith Van Horn ,863,2,9,1997,1999,2,3.7
Keith Van Horn ,863,2,9,1997,2000,3,5.5
Keith Van Horn ,863,2,9,1997,2001,4,2.8
Keith Van Horn ,863,2,9,1997,2002,5,6.3
Keith Van Horn ,863,2,9,1997,2003,6,6.5
Keith Van Horn ,863,2,9,1997,2004,7,6.3
Keith Van Horn ,863,2,9,1997,2005,8,3.5
Keith Van Horn ,863,2,9,1997,2006,9,2.3
Kelly Olynyk ,864,13,3,2013,2014,1,2.9
Kelly Olynyk ,864,13,3,2013,2015,2,3.6
Kelly Olynyk ,864,13,3,2013,2016,3,4.1
Kelly Oubre ,865,15,1,2015,2016,1,0.4
Kelly Tripucka ,866,12,10,1981,1982,1,7.5
Kelly Tripucka ,866,12,10,1981,1983,2,7.1
Kelly Tripucka ,866,12,10,1981,1984,3,5.7
Kelly Tripucka ,866,12,10,1981,1985,4,4.2
Kelly Tripucka ,866,12,10,1981,1986,5,7.5
Kelly Tripucka ,866,12,10,1981,1987,6,3.3
Kelly Tripucka ,866,12,10,1981,1988,7,1.7
Kelly Tripucka ,866,12,10,1981,1989,8,3.3
Kelly Tripucka ,866,12,10,1981,1990,9,2.1
Kelly Tripucka ,866,12,10,1981,1991,10,2
Kelvin Cato ,867,15,10,1997,1998,1,2.7
Kelvin Cato ,867,15,10,1997,1999,2,1.6
Kelvin Cato ,867,15,10,1997,2000,3,4.2
Kelvin Cato ,867,15,10,1997,2001,4,1.7
Kelvin Cato ,867,15,10,1997,2002,5,5.3
Kelvin Cato ,867,15,10,1997,2003,6,3.8
Kelvin Cato ,867,15,10,1997,2004,7,4.6
Kelvin Cato ,867,15,10,1997,2005,8,4.3
Kelvin Cato ,867,15,10,1997,2006,9,0.3
Kelvin Cato ,867,15,10,1997,2007,10,0.1
Kelvin Ransey ,868,4,6,1980,1981,1,2.8
Kelvin Ransey ,868,4,6,1980,1982,2,3.7
Kelvin Ransey ,868,4,6,1980,1983,3,2.2
Kelvin Ransey ,868,4,6,1980,1984,4,3.8
Kelvin Ransey ,868,4,6,1980,1985,5,3.4
Kelvin Ransey ,868,4,6,1980,1986,6,2
Kemba Walker ,869,9,5,2011,2012,1,0.3
Kemba Walker ,869,9,5,2011,2013,2,4.8
Kemba Walker ,869,9,5,2011,2014,3,5.1
Kemba Walker ,869,9,5,2011,2015,4,4.5
Kemba Walker ,869,9,5,2011,2016,5,9.9
Ken Green ,870,34,1,1981,1986,5,0.3
Ken Johnson ,871,49,1,2001,2003,2,0
Ken JohnsonO,872,28,1,1985,1986,1,0.8
Ken Norman ,873,19,10,1987,1988,1,0.6
Ken Norman ,873,19,10,1987,1989,2,4
Ken Norman ,873,19,10,1987,1990,3,2.9
Ken Norman ,873,19,10,1987,1991,4,4.8
Ken Norman ,873,19,10,1987,1992,5,4
Ken Norman ,873,19,10,1987,1993,6,5.2
Ken Norman ,873,19,10,1987,1994,7,1.9
Ken Norman ,873,19,10,1987,1995,8,3.2
Ken Norman ,873,19,10,1987,1996,9,1.1
Ken Norman ,873,19,10,1987,1997,10,-0.6
Kendall Gill ,874,5,15,1990,1991,1,1.8
Kendall Gill ,874,5,15,1990,1992,2,4.7
Kendall Gill ,874,5,15,1990,1993,3,2.9
Kendall Gill ,874,5,15,1990,1994,4,6.7
Kendall Gill ,874,5,15,1990,1995,5,4.6
Kendall Gill ,874,5,15,1990,1996,6,3.2
Kendall Gill ,874,5,15,1990,1997,7,8.8
Kendall Gill ,874,5,15,1990,1998,8,5.9
Kendall Gill ,874,5,15,1990,1999,9,2.6
Kendall Gill ,874,5,15,1990,2000,10,3.7
Kendall Gill ,874,5,15,1990,2001,11,-0.4
Kendall Gill ,874,5,15,1990,2002,12,0.7
Kendall Gill ,874,5,15,1990,2003,13,1.9
Kendall Gill ,874,5,15,1990,2004,14,0.4
Kendall Gill ,874,5,15,1990,2005,15,0.5
Kendall Marshall ,875,13,4,2012,2013,1,-0.2
Kendall Marshall ,875,13,4,2012,2014,2,0.9
Kendall Marshall ,875,13,4,2012,2015,3,0.8
Kendall Marshall ,875,13,4,2012,2016,4,-0.5
Kendrick Perkins ,876,27,13,2003,2004,1,0.1
Kendrick Perkins ,876,27,13,2003,2005,2,0.7
Kendrick Perkins ,876,27,13,2003,2006,3,2.3
Kendrick Perkins ,876,27,13,2003,2007,4,1.4
Kendrick Perkins ,876,27,13,2003,2008,5,6.2
Kendrick Perkins ,876,27,13,2003,2009,6,5.6
Kendrick Perkins ,876,27,13,2003,2010,7,5.2
Kendrick Perkins ,876,27,13,2003,2011,8,1
Kendrick Perkins ,876,27,13,2003,2012,9,2
Kendrick Perkins ,876,27,13,2003,2013,10,2.5
Kendrick Perkins ,876,27,13,2003,2014,11,0.8
Kendrick Perkins ,876,27,13,2003,2015,12,0.1
Kendrick Perkins ,876,27,13,2003,2016,13,-0.1
Kenneth Faried ,877,22,5,2011,2012,1,4.6
Kenneth Faried ,877,22,5,2011,2013,2,7.8
Kenneth Faried ,877,22,5,2011,2014,3,6.5
Kenneth Faried ,877,22,5,2011,2015,4,5.6
Kenneth Faried ,877,22,5,2011,2016,5,5.5
Kenny Anderson ,878,2,14,1991,1992,1,0.5
Kenny Anderson ,878,2,14,1991,1993,2,4.4
Kenny Anderson ,878,2,14,1991,1994,3,7.5
Kenny Anderson ,878,2,14,1991,1995,4,6.8
Kenny Anderson ,878,2,14,1991,1996,5,7.7
Kenny Anderson ,878,2,14,1991,1997,6,12.4
Kenny Anderson ,878,2,14,1991,1998,7,3.7
Kenny Anderson ,878,2,14,1991,1999,8,2.4
Kenny Anderson ,878,2,14,1991,2000,9,7.3
Kenny Anderson ,878,2,14,1991,2001,10,1.1
Kenny Anderson ,878,2,14,1991,2002,11,5.2
Kenny Anderson ,878,2,14,1991,2003,12,1.6
Kenny Anderson ,878,2,14,1991,2004,13,1.5
Kenny Anderson ,878,2,14,1991,2005,14,0.2
Kenny Battle ,879,27,4,1989,1990,1,1.9
Kenny Battle ,879,27,4,1989,1991,2,1.3
Kenny Battle ,879,27,4,1989,1992,3,0.3
Kenny Battle ,879,27,4,1989,1993,4,0.1
Kenny Fields ,880,21,4,1984,1985,1,0.7
Kenny Fields ,880,21,4,1984,1986,2,2.8
Kenny Fields ,880,21,4,1984,1987,3,0.7
Kenny Fields ,880,21,4,1984,1988,4,0
Kenny Green ,881,12,2,1985,1986,1,0
Kenny Green ,881,12,2,1985,1987,2,-0.3
Kenny Natt ,882,30,3,1980,1981,1,-0.2
Kenny Natt ,882,30,3,1980,1983,3,0.1
Kenny Natt ,882,30,3,1980,1985,5,0
Kenny Payne ,883,19,4,1989,1990,1,0
Kenny Payne ,883,19,4,1989,1991,2,-0.3
Kenny Payne ,883,19,4,1989,1992,3,0.2
Kenny Payne ,883,19,4,1989,1993,4,0
Kenny Smith ,884,6,10,1987,1988,1,2.2
Kenny Smith ,884,6,10,1987,1989,2,4.1
Kenny Smith ,884,6,10,1987,1990,3,2.6
Kenny Smith ,884,6,10,1987,1991,4,9
Kenny Smith ,884,6,10,1987,1992,5,5.1
Kenny Smith ,884,6,10,1987,1993,6,8.2
Kenny Smith ,884,6,10,1987,1994,7,6.1
Kenny Smith ,884,6,10,1987,1995,8,6.1
Kenny Smith ,884,6,10,1987,1996,9,2.9
Kenny Smith ,884,6,10,1987,1997,10,0.6
Kenny Thomas ,885,22,11,1999,2000,1,2.2
Kenny Thomas ,885,22,11,1999,2001,2,2.2
Kenny Thomas ,885,22,11,1999,2002,3,4.4
Kenny Thomas ,885,22,11,1999,2003,4,4.6
Kenny Thomas ,885,22,11,1999,2004,5,6.6
Kenny Thomas ,885,22,11,1999,2005,6,4.3
Kenny Thomas ,885,22,11,1999,2006,7,5.5
Kenny Thomas ,885,22,11,1999,2007,8,1.2
Kenny Thomas ,885,22,11,1999,2008,9,-0.3
Kenny Thomas ,885,22,11,1999,2009,10,0.1
Kenny Thomas ,885,22,11,1999,2010,11,0.4
Kenny Walker ,886,5,7,1986,1987,1,3.1
Kenny Walker ,886,5,7,1986,1988,2,4.7
Kenny Walker ,886,5,7,1986,1989,3,2.7
Kenny Walker ,886,5,7,1986,1990,4,4
Kenny Walker ,886,5,7,1986,1991,5,1.3
Kenny Walker ,886,5,7,1986,1994,8,1.9
Kenny Walker ,886,5,7,1986,1995,9,0.1
Kenny Williams ,887,46,4,1990,1991,1,0.7
Kenny Williams ,887,46,4,1990,1992,2,1.6
Kenny Williams ,887,46,4,1990,1993,3,2.7
Kenny Williams ,887,46,4,1990,1994,4,2.4
Kentavious Caldwell-Pope ,888,8,3,2013,2014,1,1.8
Kentavious Caldwell-Pope ,888,8,3,2013,2015,2,2.8
Kentavious Caldwell-Pope ,888,8,3,2013,2016,3,5.3
Kenyon Martin ,889,1,15,2000,2001,1,2.1
Kenyon Martin ,889,1,15,2000,2002,2,4.9
Kenyon Martin ,889,1,15,2000,2003,3,7.1
Kenyon Martin ,889,1,15,2000,2004,4,6.7
Kenyon Martin ,889,1,15,2000,2005,5,5.3
Kenyon Martin ,889,1,15,2000,2006,6,3.8
Kenyon Martin ,889,1,15,2000,2007,7,0
Kenyon Martin ,889,1,15,2000,2008,8,5
Kenyon Martin ,889,1,15,2000,2009,9,4
Kenyon Martin ,889,1,15,2000,2010,10,3.3
Kenyon Martin ,889,1,15,2000,2011,11,2.7
Kenyon Martin ,889,1,15,2000,2012,12,0.9
Kenyon Martin ,889,1,15,2000,2013,13,1.2
Kenyon Martin ,889,1,15,2000,2014,14,1.2
Kenyon Martin ,889,1,15,2000,2015,15,0.2
Keon Clark ,890,13,6,1998,1999,1,0.2
Keon Clark ,890,13,6,1998,2000,2,4.2
Keon Clark ,890,13,6,1998,2001,3,3.7
Keon Clark ,890,13,6,1998,2002,4,5.3
Keon Clark ,890,13,6,1998,2003,5,4.7
Keon Clark ,890,13,6,1998,2004,6,0
Kerry Kittles ,891,8,8,1996,1997,1,6.9
Kerry Kittles ,891,8,8,1996,1998,2,8.4
Kerry Kittles ,891,8,8,1996,1999,3,1.8
Kerry Kittles ,891,8,8,1996,2000,4,4.7
Kerry Kittles ,891,8,8,1996,2002,6,7.7
Kerry Kittles ,891,8,8,1996,2003,7,7.7
Kerry Kittles ,891,8,8,1996,2004,8,7.6
Kerry Kittles ,891,8,8,1996,2005,9,0.2
Kevin Brooks ,892,18,3,1991,1992,1,0.1
Kevin Brooks ,892,18,3,1991,1993,2,0
Kevin Brooks ,892,18,3,1991,1994,3,-0.2
Kevin Duckworth ,893,33,11,1986,1987,1,0.8
Kevin Duckworth ,893,33,11,1986,1988,2,5.2
Kevin Duckworth ,893,33,11,1986,1989,3,4.8
Kevin Duckworth ,893,33,11,1986,1990,4,4.8
Kevin Duckworth ,893,33,11,1986,1991,5,4.3
Kevin Duckworth ,893,33,11,1986,1992,6,3.3
Kevin Duckworth ,893,33,11,1986,1993,7,2.5
Kevin Duckworth ,893,33,11,1986,1994,8,-0.5
Kevin Duckworth ,893,33,11,1986,1995,9,0
Kevin Duckworth ,893,33,11,1986,1996,10,-0.1
Kevin Duckworth ,893,33,11,1986,1997,11,-0.2
Kevin Durant ,894,2,9,2007,2008,1,2.3
Kevin Durant ,894,2,9,2007,2009,2,7.9
Kevin Durant ,894,2,9,2007,2010,3,16.1
Kevin Durant ,894,2,9,2007,2011,4,12
Kevin Durant ,894,2,9,2007,2012,5,12.2
Kevin Durant ,894,2,9,2007,2013,6,18.9
Kevin Durant ,894,2,9,2007,2014,7,19.2
Kevin Durant ,894,2,9,2007,2015,8,4.8
Kevin Durant ,894,2,9,2007,2016,9,14.5
Kevin Edwards ,895,20,11,1988,1989,1,-0.2
Kevin Edwards ,895,20,11,1988,1990,2,0.3
Kevin Edwards ,895,20,11,1988,1991,3,1.6
Kevin Edwards ,895,20,11,1988,1992,4,2.4
Kevin Edwards ,895,20,11,1988,1993,5,2.5
Kevin Edwards ,895,20,11,1988,1994,6,5.1
Kevin Edwards ,895,20,11,1988,1995,7,0.6
Kevin Edwards ,895,20,11,1988,1996,8,0.5
Kevin Edwards ,895,20,11,1988,1997,9,-0.2
Kevin Edwards ,895,20,11,1988,1998,10,0.1
Kevin Edwards ,895,20,11,1988,2001,13,-0.1
Kevin Garnett ,896,5,21,1995,1996,1,4.4
Kevin Garnett ,896,5,21,1995,1997,2,7.3
Kevin Garnett ,896,5,21,1995,1998,3,9.6
Kevin Garnett ,896,5,21,1995,1999,4,5.4
Kevin Garnett ,896,5,21,1995,2000,5,11.6
Kevin Garnett ,896,5,21,1995,2001,6,11.8
Kevin Garnett ,896,5,21,1995,2002,7,12.8
Kevin Garnett ,896,5,21,1995,2003,8,15.6
Kevin Garnett ,896,5,21,1995,2004,9,18.3
Kevin Garnett ,896,5,21,1995,2005,10,16.1
Kevin Garnett ,896,5,21,1995,2006,11,14.9
Kevin Garnett ,896,5,21,1995,2007,12,10.7
Kevin Garnett ,896,5,21,1995,2008,13,12.9
Kevin Garnett ,896,5,21,1995,2009,14,7.1
Kevin Garnett ,896,5,21,1995,2010,15,7.3
Kevin Garnett ,896,5,21,1995,2011,16,9
Kevin Garnett ,896,5,21,1995,2012,17,6.9
Kevin Garnett ,896,5,21,1995,2013,18,5.6
Kevin Garnett ,896,5,21,1995,2014,19,1.2
Kevin Garnett ,896,5,21,1995,2015,20,1.9
Kevin Garnett ,896,5,21,1995,2016,21,1.1
Kevin Henderson ,897,50,2,1986,1987,1,0
Kevin Henderson ,897,50,2,1986,1988,2,-0.2
Kevin Johnson ,898,7,12,1987,1988,1,4
Kevin Johnson ,898,7,12,1987,1989,2,12.2
Kevin Johnson ,898,7,12,1987,1990,3,11.6
Kevin Johnson ,898,7,12,1987,1991,4,12.7
Kevin Johnson ,898,7,12,1987,1992,5,10
Kevin Johnson ,898,7,12,1987,1993,6,5.1
Kevin Johnson ,898,7,12,1987,1994,7,8.7
Kevin Johnson ,898,7,12,1987,1995,8,4.8
Kevin Johnson ,898,7,12,1987,1996,9,8.2
Kevin Johnson ,898,7,12,1987,1997,10,11.7
Kevin Johnson ,898,7,12,1987,1998,11,3.5
Kevin Johnson ,898,7,12,1987,2000,13,0.5
Kevin Loder ,899,17,3,1981,1982,1,1.5
Kevin Loder ,899,17,3,1981,1983,2,0.9
Kevin Loder ,899,17,3,1981,1984,3,0.1
Kevin Love ,900,5,8,2008,2009,1,5.3
Kevin Love ,900,5,8,2008,2010,2,4.9
Kevin Love ,900,5,8,2008,2011,3,11.4
Kevin Love ,900,5,8,2008,2012,4,10
Kevin Love ,900,5,8,2008,2013,5,1.1
Kevin Love ,900,5,8,2008,2014,6,14.3
Kevin Love ,900,5,8,2008,2015,7,8.7
Kevin Love ,900,5,8,2008,2016,8,8.5
Kevin Lynch ,901,28,2,1991,1992,1,0.2
Kevin Lynch ,901,28,2,1991,1993,2,0.2
Kevin Martin ,902,26,12,2004,2005,1,0.1
Kevin Martin ,902,26,12,2004,2006,2,5.5
Kevin Martin ,902,26,12,2004,2007,3,10.2
Kevin Martin ,902,26,12,2004,2008,4,8.4
Kevin Martin ,902,26,12,2004,2009,5,4.7
Kevin Martin ,902,26,12,2004,2010,6,4.2
Kevin Martin ,902,26,12,2004,2011,7,9.5
Kevin Martin ,902,26,12,2004,2012,8,3.3
Kevin Martin ,902,26,12,2004,2013,9,7
Kevin Martin ,902,26,12,2004,2014,10,5.3
Kevin Martin ,902,26,12,2004,2015,11,1.9
Kevin Martin ,902,26,12,2004,2016,12,1.2
Kevin Murphy ,903,47,1,2012,2013,1,-0.3
Kevin Pritchard ,904,34,4,1990,1991,1,-0.2
Kevin Pritchard ,904,34,4,1990,1992,2,0.2
Kevin Pritchard ,904,34,4,1990,1995,5,0.2
Kevin Pritchard ,904,34,4,1990,1996,6,0.2
Kevin Seraphin ,905,17,6,2010,2011,1,0.2
Kevin Seraphin ,905,17,6,2010,2012,2,2.3
Kevin Seraphin ,905,17,6,2010,2013,3,0.1
Kevin Seraphin ,905,17,6,2010,2014,4,0.8
Kevin Seraphin ,905,17,6,2010,2015,5,1.7
Kevin Seraphin ,905,17,6,2010,2016,6,-0.2
Kevin Thompson ,906,48,1,1993,1994,1,0
Kevin Williams ,907,46,5,1983,1984,1,0.1
Kevin Williams ,907,46,5,1983,1985,2,0.1
Kevin Williams ,907,46,5,1983,1987,4,0.6
Kevin Williams ,907,46,5,1983,1988,5,1.9
Kevin Williams ,907,46,5,1983,1989,6,-0.1
Kevin Willis ,908,11,21,1984,1985,1,2.7
Kevin Willis ,908,11,21,1984,1986,2,4.7
Kevin Willis ,908,11,21,1984,1987,3,8.6
Kevin Willis ,908,11,21,1984,1988,4,4.2
Kevin Willis ,908,11,21,1984,1990,6,4.7
Kevin Willis ,908,11,21,1984,1991,7,4.4
Kevin Willis ,908,11,21,1984,1992,8,8.8
Kevin Willis ,908,11,21,1984,1993,9,6
Kevin Willis ,908,11,21,1984,1994,10,10.2
Kevin Willis ,908,11,21,1984,1995,11,3.6
Kevin Willis ,908,11,21,1984,1996,12,2.2
Kevin Willis ,908,11,21,1984,1997,13,3.8
Kevin Willis ,908,11,21,1984,1998,14,6
Kevin Willis ,908,11,21,1984,1999,15,2.4
Kevin Willis ,908,11,21,1984,2000,16,2.3
Kevin Willis ,908,11,21,1984,2001,17,3.1
Kevin Willis ,908,11,21,1984,2002,18,1.7
Kevin Willis ,908,11,21,1984,2003,19,1.6
Kevin Willis ,908,11,21,1984,2004,20,0.9
Kevin Willis ,908,11,21,1984,2005,21,0
Kevin Willis ,908,11,21,1984,2007,23,0
Kevon Looney ,909,30,1,2015,2016,1,0.1
Keyon Dooling ,910,10,13,2000,2001,1,1.4
Keyon Dooling ,910,10,13,2000,2002,2,0
Keyon Dooling ,910,10,13,2000,2003,3,0.3
Keyon Dooling ,910,10,13,2000,2004,4,0.3
Keyon Dooling ,910,10,13,2000,2005,5,1.5
Keyon Dooling ,910,10,13,2000,2006,6,1.1
Keyon Dooling ,910,10,13,2000,2007,7,2.1
Keyon Dooling ,910,10,13,2000,2008,8,3.7
Keyon Dooling ,910,10,13,2000,2009,9,3.7
Keyon Dooling ,910,10,13,2000,2010,10,0.7
Keyon Dooling ,910,10,13,2000,2011,11,2.9
Keyon Dooling ,910,10,13,2000,2012,12,0.6
Keyon Dooling ,910,10,13,2000,2013,13,0.2
Khalid El-Amin ,911,34,1,2000,2001,1,0.6
Khalid Reeves ,912,12,6,1994,1995,1,3.5
Khalid Reeves ,912,12,6,1994,1996,2,1.1
Khalid Reeves ,912,12,6,1994,1997,3,1.2
Khalid Reeves ,912,12,6,1994,1998,4,2.5
Khalid Reeves ,912,12,6,1994,1999,5,0.1
Khalid Reeves ,912,12,6,1994,2000,6,0
Khris Middleton ,913,39,4,2012,2013,1,0.9
Khris Middleton ,913,39,4,2012,2014,2,2.7
Khris Middleton ,913,39,4,2012,2015,3,6.7
Khris Middleton ,913,39,4,2012,2016,4,6.1
Kiki Vandeweghe ,914,11,13,1980,1981,1,1.2
Kiki Vandeweghe ,914,11,13,1980,1982,2,7.7
Kiki Vandeweghe ,914,11,13,1980,1983,3,11
Kiki Vandeweghe ,914,11,13,1980,1984,4,10.3
Kiki Vandeweghe ,914,11,13,1980,1985,5,8.4
Kiki Vandeweghe ,914,11,13,1980,1986,6,9.9
Kiki Vandeweghe ,914,11,13,1980,1987,7,10.8
Kiki Vandeweghe ,914,11,13,1980,1988,8,3.8
Kiki Vandeweghe ,914,11,13,1980,1989,9,2
Kiki Vandeweghe ,914,11,13,1980,1990,10,0.8
Kiki Vandeweghe ,914,11,13,1980,1991,11,5.7
Kiki Vandeweghe ,914,11,13,1980,1992,12,2.9
Kiki Vandeweghe ,914,11,13,1980,1993,13,1.1
Kim English ,915,44,1,2012,2013,1,0.2
Kirk Haston ,916,16,2,2001,2002,1,-0.2
Kirk Haston ,916,16,2,2001,2003,2,-0.4
Kirk Hinrich ,917,7,13,2003,2004,1,4.1
Kirk Hinrich ,917,7,13,2003,2005,2,7.2
Kirk Hinrich ,917,7,13,2003,2006,3,7.6
Kirk Hinrich ,917,7,13,2003,2007,4,10.1
Kirk Hinrich ,917,7,13,2003,2008,5,3.6
Kirk Hinrich ,917,7,13,2003,2009,6,2.6
Kirk Hinrich ,917,7,13,2003,2010,7,4
Kirk Hinrich ,917,7,13,2003,2011,8,3
Kirk Hinrich ,917,7,13,2003,2012,9,1.8
Kirk Hinrich ,917,7,13,2003,2013,10,3.1
Kirk Hinrich ,917,7,13,2003,2014,11,3.8
Kirk Hinrich ,917,7,13,2003,2015,12,1
Kirk Hinrich ,917,7,13,2003,2016,13,0.6
Kirk Snyder ,918,16,4,2004,2005,1,-0.2
Kirk Snyder ,918,16,4,2004,2006,2,2.2
Kirk Snyder ,918,16,4,2004,2007,3,1.4
Kirk Snyder ,918,16,4,2004,2008,4,1.1
Klay Thompson ,919,11,5,2011,2012,1,1.7
Klay Thompson ,919,11,5,2011,2013,2,4.3
Klay Thompson ,919,11,5,2011,2014,3,6.7
Klay Thompson ,919,11,5,2011,2015,4,8.8
Klay Thompson ,919,11,5,2011,2016,5,8
Kobe Bryant ,920,13,20,1996,1997,1,1.8
Kobe Bryant ,920,13,20,1996,1998,2,6.3
Kobe Bryant ,920,13,20,1996,1999,3,5.2
Kobe Bryant ,920,13,20,1996,2000,4,10.6
Kobe Bryant ,920,13,20,1996,2001,5,11.3
Kobe Bryant ,920,13,20,1996,2002,6,12.7
Kobe Bryant ,920,13,20,1996,2003,7,14.9
Kobe Bryant ,920,13,20,1996,2004,8,10.7
Kobe Bryant ,920,13,20,1996,2005,9,8.1
Kobe Bryant ,920,13,20,1996,2006,10,15.3
Kobe Bryant ,920,13,20,1996,2007,11,13
Kobe Bryant ,920,13,20,1996,2008,12,13.8
Kobe Bryant ,920,13,20,1996,2009,13,12.7
Kobe Bryant ,920,13,20,1996,2010,14,9.4
Kobe Bryant ,920,13,20,1996,2011,15,10.3
Kobe Bryant ,920,13,20,1996,2012,16,6.2
Kobe Bryant ,920,13,20,1996,2013,17,10.9
Kobe Bryant ,920,13,20,1996,2014,18,-0.4
Kobe Bryant ,920,13,20,1996,2015,19,0.2
Kobe Bryant ,920,13,20,1996,2016,20,-0.4
Korleone Young ,921,40,1,1998,1999,1,0.1
Kosta Koufos ,922,23,8,2008,2009,1,1.3
Kosta Koufos ,922,23,8,2008,2010,2,0
Kosta Koufos ,922,23,8,2008,2011,3,0.2
Kosta Koufos ,922,23,8,2008,2012,4,2.7
Kosta Koufos ,922,23,8,2008,2013,5,6.5
Kosta Koufos ,922,23,8,2008,2014,6,3.5
Kosta Koufos ,922,23,8,2008,2015,7,3.3
Kosta Koufos ,922,23,8,2008,2016,8,3.5
Kosta Perovic ,923,38,1,2006,2008,2,0
Kostas Papanikolaou ,924,48,2,2012,2015,3,0.5
Kostas Papanikolaou ,924,48,2,2012,2016,4,-0.1
Kris Humphries ,925,14,12,2004,2005,1,-0.3
Kris Humphries ,925,14,12,2004,2006,2,0.2
Kris Humphries ,925,14,12,2004,2007,3,1.5
Kris Humphries ,925,14,12,2004,2008,4,1.8
Kris Humphries ,925,14,12,2004,2009,5,0.7
Kris Humphries ,925,14,12,2004,2010,6,1.9
Kris Humphries ,925,14,12,2004,2011,7,5.4
Kris Humphries ,925,14,12,2004,2012,8,5.3
Kris Humphries ,925,14,12,2004,2013,9,2.7
Kris Humphries ,925,14,12,2004,2014,10,4.1
Kris Humphries ,925,14,12,2004,2015,11,3.8
Kris Humphries ,925,14,12,2004,2016,12,1.6
Kristaps Porzingis ,926,4,1,2015,2016,1,4.3
Kurt Nimphius ,927,47,8,1980,1982,2,1.5
Kurt Nimphius ,927,47,8,1980,1983,3,2.9
Kurt Nimphius ,927,47,8,1980,1984,4,4.8
Kurt Nimphius ,927,47,8,1980,1985,5,3.3
Kurt Nimphius ,927,47,8,1980,1986,6,3.1
Kurt Nimphius ,927,47,8,1980,1987,7,0.7
Kurt Nimphius ,927,47,8,1980,1988,8,1
Kurt Nimphius ,927,47,8,1980,1990,10,0.1
Kurt Thomas ,928,10,18,1995,1996,1,3.8
Kurt Thomas ,928,10,18,1995,1997,2,0.5
Kurt Thomas ,928,10,18,1995,1998,3,-0.2
Kurt Thomas ,928,10,18,1995,1999,4,2.5
Kurt Thomas ,928,10,18,1995,2000,5,5.2
Kurt Thomas ,928,10,18,1995,2001,6,8.2
Kurt Thomas ,928,10,18,1995,2002,7,6.5
Kurt Thomas ,928,10,18,1995,2003,8,5.4
Kurt Thomas ,928,10,18,1995,2004,9,5
Kurt Thomas ,928,10,18,1995,2005,10,5.2
Kurt Thomas ,928,10,18,1995,2006,11,3.3
Kurt Thomas ,928,10,18,1995,2007,12,2.9
Kurt Thomas ,928,10,18,1995,2008,13,4.1
Kurt Thomas ,928,10,18,1995,2009,14,4.5
Kurt Thomas ,928,10,18,1995,2010,15,2.1
Kurt Thomas ,928,10,18,1995,2011,16,3.2
Kurt Thomas ,928,10,18,1995,2012,17,1.1
Kurt Thomas ,928,10,18,1995,2013,18,1.1
Kwame Brown ,929,1,12,2001,2002,1,0.8
Kwame Brown ,929,1,12,2001,2003,2,2.5
Kwame Brown ,929,1,12,2001,2004,3,4.9
Kwame Brown ,929,1,12,2001,2005,4,0.6
Kwame Brown ,929,1,12,2001,2006,5,3.6
Kwame Brown ,929,1,12,2001,2007,6,1.9
Kwame Brown ,929,1,12,2001,2008,7,0.6
Kwame Brown ,929,1,12,2001,2009,8,1.9
Kwame Brown ,929,1,12,2001,2010,9,-0.1
Kwame Brown ,929,1,12,2001,2011,10,3.5
Kwame Brown ,929,1,12,2001,2012,11,0.1
Kwame Brown ,929,1,12,2001,2013,12,0.4
Kyle Anderson ,930,30,2,2014,2015,1,0.3
Kyle Anderson ,930,30,2,2014,2016,2,3.5
Kyle Lowry ,931,24,10,2006,2007,1,0.5
Kyle Lowry ,931,24,10,2006,2008,2,3.4
Kyle Lowry ,931,24,10,2006,2009,3,3.6
Kyle Lowry ,931,24,10,2006,2010,4,4.3
Kyle Lowry ,931,24,10,2006,2011,5,7
Kyle Lowry ,931,24,10,2006,2012,6,4.9
Kyle Lowry ,931,24,10,2006,2013,7,5.6
Kyle Lowry ,931,24,10,2006,2014,8,11.7
Kyle Lowry ,931,24,10,2006,2015,9,7.1
Kyle Lowry ,931,24,10,2006,2016,10,11.6
Kyle Macy ,932,22,7,1979,1981,2,4.5
Kyle Macy ,932,22,7,1979,1982,3,9.2
Kyle Macy ,932,22,7,1979,1983,4,6.4
Kyle Macy ,932,22,7,1979,1984,5,5
Kyle Macy ,932,22,7,1979,1985,6,4.6
Kyle Macy ,932,22,7,1979,1986,7,3.9
Kyle Macy ,932,22,7,1979,1987,8,2.4
Kyle O'Quinn ,933,49,4,2012,2013,1,1.4
Kyle O'Quinn ,933,49,4,2012,2014,2,2.5
Kyle O'Quinn ,933,49,4,2012,2015,3,1.6
Kyle O'Quinn ,933,49,4,2012,2016,4,1.6
Kyle Singler ,934,33,4,2011,2013,2,2.3
Kyle Singler ,934,33,4,2011,2014,3,4.4
Kyle Singler ,934,33,4,2011,2015,4,2
Kyle Singler ,934,33,4,2011,2016,5,1.1
Kyle Weaver ,935,38,3,2008,2009,1,1.2
Kyle Weaver ,935,38,3,2008,2010,2,0.3
Kyle Weaver ,935,38,3,2008,2011,3,0
Kyrie Irving ,936,1,5,2011,2012,1,4.1
Kyrie Irving ,936,1,5,2011,2013,2,5.3
Kyrie Irving ,936,1,5,2011,2014,3,6.7
Kyrie Irving ,936,1,5,2011,2015,4,10.4
Kyrie Irving ,936,1,5,2011,2016,5,5
Kyrylo Fesenko ,937,38,5,2007,2008,1,0
Kyrylo Fesenko ,937,38,5,2007,2009,2,0.3
Kyrylo Fesenko ,937,38,5,2007,2010,3,0.6
Kyrylo Fesenko ,937,38,5,2007,2011,4,-0.1
Kyrylo Fesenko ,937,38,5,2007,2012,5,0.1
LaBradford Smith ,938,19,3,1991,1992,1,-0.1
LaBradford Smith ,938,19,3,1991,1993,2,0.8
LaBradford Smith ,938,19,3,1991,1994,3,0.8
Lamar Odom ,939,4,14,1999,2000,1,3.2
Lamar Odom ,939,4,14,1999,2001,2,6.5
Lamar Odom ,939,4,14,1999,2002,3,0.7
Lamar Odom ,939,4,14,1999,2003,4,2.2
Lamar Odom ,939,4,14,1999,2004,5,8.4
Lamar Odom ,939,4,14,1999,2005,6,4.7
Lamar Odom ,939,4,14,1999,2006,7,9.2
Lamar Odom ,939,4,14,1999,2007,8,4.7
Lamar Odom ,939,4,14,1999,2008,9,9.7
Lamar Odom ,939,4,14,1999,2009,10,6.9
Lamar Odom ,939,4,14,1999,2010,11,7.7
Lamar Odom ,939,4,14,1999,2011,12,10.1
Lamar Odom ,939,4,14,1999,2012,13,0.3
Lamar Odom ,939,4,14,1999,2013,14,2.7
Lamar Patterson ,940,48,1,2014,2016,2,0.2
LaMarcus Aldridge ,941,2,10,2006,2007,1,3.4
LaMarcus Aldridge ,941,2,10,2006,2008,2,6.2
LaMarcus Aldridge ,941,2,10,2006,2009,3,9.5
LaMarcus Aldridge ,941,2,10,2006,2010,4,8.8
LaMarcus Aldridge ,941,2,10,2006,2011,5,11.1
LaMarcus Aldridge ,941,2,10,2006,2012,6,7
LaMarcus Aldridge ,941,2,10,2006,2013,7,7.2
LaMarcus Aldridge ,941,2,10,2006,2014,8,7.5
LaMarcus Aldridge ,941,2,10,2006,2015,9,8.6
LaMarcus Aldridge ,941,2,10,2006,2016,10,10.1
Lamond Murray ,942,7,11,1994,1995,1,-0.3
Lamond Murray ,942,7,11,1994,1996,2,1.2
Lamond Murray ,942,7,11,1994,1997,3,2.1
Lamond Murray ,942,7,11,1994,1998,4,4.9
Lamond Murray ,942,7,11,1994,1999,5,0.3
Lamond Murray ,942,7,11,1994,2000,6,3.3
Lamond Murray ,942,7,11,1994,2001,7,2.3
Lamond Murray ,942,7,11,1994,2002,8,4.1
Lamond Murray ,942,7,11,1994,2004,10,-0.3
Lamond Murray ,942,7,11,1994,2005,11,1.3
Lamond Murray ,942,7,11,1994,2006,12,0.9
Lamont Strothers ,943,43,2,1991,1992,1,-0.1
Lamont Strothers ,943,43,2,1991,1993,2,-0.4
Lancaster Gordon ,944,8,4,1984,1985,1,-0.8
Lancaster Gordon ,944,8,4,1984,1986,2,-1.1
Lancaster Gordon ,944,8,4,1984,1987,3,-0.8
Lancaster Gordon ,944,8,4,1984,1988,4,0
Lance Blanks ,945,26,3,1990,1991,1,0.1
Lance Blanks ,945,26,3,1990,1992,2,0.4
Lance Blanks ,945,26,3,1990,1993,3,0.2
Lance Stephenson ,946,40,6,2010,2011,1,-0.2
Lance Stephenson ,946,40,6,2010,2012,2,-0.3
Lance Stephenson ,946,40,6,2010,2013,3,5.5
Lance Stephenson ,946,40,6,2010,2014,4,7.4
Lance Stephenson ,946,40,6,2010,2015,5,-0.9
Lance Stephenson ,946,40,6,2010,2016,6,2.2
Landry Fields ,947,39,5,2010,2011,1,5.3
Landry Fields ,947,39,5,2010,2012,2,3.4
Landry Fields ,947,39,5,2010,2013,3,1.1
Landry Fields ,947,39,5,2010,2014,4,0.4
Landry Fields ,947,39,5,2010,2015,5,0.3
LaPhonso Ellis ,948,5,11,1992,1993,1,8
LaPhonso Ellis ,948,5,11,1992,1994,2,7.6
LaPhonso Ellis ,948,5,11,1992,1995,3,0
LaPhonso Ellis ,948,5,11,1992,1996,4,1
LaPhonso Ellis ,948,5,11,1992,1997,5,3.6
LaPhonso Ellis ,948,5,11,1992,1998,6,1.4
LaPhonso Ellis ,948,5,11,1992,1999,7,0.8
LaPhonso Ellis ,948,5,11,1992,2000,8,1.9
LaPhonso Ellis ,948,5,11,1992,2001,9,5.2
LaPhonso Ellis ,948,5,11,1992,2002,10,2.2
LaPhonso Ellis ,948,5,11,1992,2003,11,1.1
Lari Ketner ,949,49,2,1999,2000,1,0
Lari Ketner ,949,49,2,1999,2001,2,-0.1
Laron Profit ,950,38,4,1999,2000,1,-0.3
Laron Profit ,950,38,4,1999,2001,2,0.3
Laron Profit ,950,38,4,1999,2005,6,0.4
Laron Profit ,950,38,4,1999,2006,7,0.3
Larry Demic ,951,9,3,1979,1980,1,-0.1
Larry Demic ,951,9,3,1979,1981,2,1.6
Larry Demic ,951,9,3,1979,1982,3,-0.1
Larry Drew ,952,17,10,1980,1981,1,0
Larry Drew ,952,17,10,1980,1982,2,3
Larry Drew ,952,17,10,1980,1983,3,7.2
Larry Drew ,952,17,10,1980,1984,4,4.6
Larry Drew ,952,17,10,1980,1985,5,3.6
Larry Drew ,952,17,10,1980,1986,6,2.8
Larry Drew ,952,17,10,1980,1987,7,0.1
Larry Drew ,952,17,10,1980,1988,8,1.2
Larry Drew ,952,17,10,1980,1990,10,1.4
Larry Drew ,952,17,10,1980,1991,11,0.5
Larry Drew ,952,17,10,1980,2015,35,-0.4
Larry Hughes ,953,8,13,1998,1999,1,2.4
Larry Hughes ,953,8,13,1998,2000,2,1.7
Larry Hughes ,953,8,13,1998,2001,3,0.6
Larry Hughes ,953,8,13,1998,2002,4,2.4
Larry Hughes ,953,8,13,1998,2003,5,3.7
Larry Hughes ,953,8,13,1998,2004,6,3.8
Larry Hughes ,953,8,13,1998,2005,7,7.7
Larry Hughes ,953,8,13,1998,2006,8,1.8
Larry Hughes ,953,8,13,1998,2007,9,3.9
Larry Hughes ,953,8,13,1998,2008,10,1.8
Larry Hughes ,953,8,13,1998,2009,11,2.1
Larry Hughes ,953,8,13,1998,2010,12,0.7
Larry Hughes ,953,8,13,1998,2012,14,-0.5
Larry Johnson ,954,1,10,1991,1992,1,8.9
Larry Johnson ,954,1,10,1991,1993,2,9.6
Larry Johnson ,954,1,10,1991,1994,3,3.9
Larry Johnson ,954,1,10,1991,1995,4,8.5
Larry Johnson ,954,1,10,1991,1996,5,10.1
Larry Johnson ,954,1,10,1991,1997,6,7.7
Larry Johnson ,954,1,10,1991,1998,7,6.9
Larry Johnson ,954,1,10,1991,1999,8,4.9
Larry Johnson ,954,1,10,1991,2000,9,5.1
Larry Johnson ,954,1,10,1991,2001,10,4.1
Larry Krystkowiak ,955,28,9,1986,1987,1,1.4
Larry Krystkowiak ,955,28,9,1986,1988,2,2.1
Larry Krystkowiak ,955,28,9,1986,1989,3,6.3
Larry Krystkowiak ,955,28,9,1986,1990,4,0.1
Larry Krystkowiak ,955,28,9,1986,1992,6,1.8
Larry Krystkowiak ,955,28,9,1986,1993,7,2.6
Larry Krystkowiak ,955,28,9,1986,1994,8,1
Larry Krystkowiak ,955,28,9,1986,1995,9,0.3
Larry Krystkowiak ,955,28,9,1986,1997,11,0.1
Larry Micheaux ,956,29,2,1983,1984,1,0.9
Larry Micheaux ,956,29,2,1983,1985,2,1.6
Larry Nance ,957,20,13,1981,1982,1,2.4
Larry Nance ,957,20,13,1981,1983,2,10.5
Larry Nance ,957,20,13,1981,1984,3,9.8
Larry Nance ,957,20,13,1981,1985,4,7.9
Larry Nance ,957,20,13,1981,1986,5,8.4
Larry Nance ,957,20,13,1981,1987,6,10.2
Larry Nance ,957,20,13,1981,1988,7,8
Larry Nance ,957,20,13,1981,1989,8,10.3
Larry Nance ,957,20,13,1981,1990,9,6.5
Larry Nance ,957,20,13,1981,1991,10,9.8
Larry Nance ,957,20,13,1981,1992,11,12.2
Larry Nance ,957,20,13,1981,1993,12,10.7
Larry Nance ,957,20,13,1981,1994,13,2.8
Larry Nance Jr. ,958,27,1,2015,2016,1,2.2
Larry Sanders ,959,15,5,2010,2011,1,1
Larry Sanders ,959,15,5,2010,2012,2,1
Larry Sanders ,959,15,5,2010,2013,3,6
Larry Sanders ,959,15,5,2010,2014,4,0.7
Larry Sanders ,959,15,5,2010,2015,5,1.6
Larry Smith ,960,24,13,1980,1981,1,6.1
Larry Smith ,960,24,13,1980,1982,2,5.2
Larry Smith ,960,24,13,1980,1983,3,3.1
Larry Smith ,960,24,13,1980,1984,4,4
Larry Smith ,960,24,13,1980,1985,5,4.7
Larry Smith ,960,24,13,1980,1986,6,4.3
Larry Smith ,960,24,13,1980,1987,7,5.4
Larry Smith ,960,24,13,1980,1988,8,0.3
Larry Smith ,960,24,13,1980,1989,9,3.7
Larry Smith ,960,24,13,1980,1990,10,2.6
Larry Smith ,960,24,13,1980,1991,11,4.4
Larry Smith ,960,24,13,1980,1992,12,1.2
Larry Smith ,960,24,13,1980,1993,13,1.2
LaSalle Thompson ,961,5,15,1982,1983,1,2.3
LaSalle Thompson ,961,5,15,1982,1984,2,4.9
LaSalle Thompson ,961,5,15,1982,1985,3,5.3
LaSalle Thompson ,961,5,15,1982,1986,4,5.6
LaSalle Thompson ,961,5,15,1982,1987,5,4.5
LaSalle Thompson ,961,5,15,1982,1988,6,1.9
LaSalle Thompson ,961,5,15,1982,1989,7,4.4
LaSalle Thompson ,961,5,15,1982,1990,8,2.4
LaSalle Thompson ,961,5,15,1982,1991,9,1.2
LaSalle Thompson ,961,5,15,1982,1992,10,1.6
LaSalle Thompson ,961,5,15,1982,1993,11,0.9
LaSalle Thompson ,961,5,15,1982,1994,12,0
LaSalle Thompson ,961,5,15,1982,1995,13,0.1
LaSalle Thompson ,961,5,15,1982,1996,14,0.2
LaSalle Thompson ,961,5,15,1982,1997,15,-0.3
Latrell Sprewell ,962,24,13,1992,1993,1,4
Latrell Sprewell ,962,24,13,1992,1994,2,8
Latrell Sprewell ,962,24,13,1992,1995,3,2
Latrell Sprewell ,962,24,13,1992,1996,4,5.5
Latrell Sprewell ,962,24,13,1992,1997,5,8.1
Latrell Sprewell ,962,24,13,1992,1998,6,0.4
Latrell Sprewell ,962,24,13,1992,1999,7,3
Latrell Sprewell ,962,24,13,1992,2000,8,6.6
Latrell Sprewell ,962,24,13,1992,2001,9,5.1
Latrell Sprewell ,962,24,13,1992,2002,10,2.8
Latrell Sprewell ,962,24,13,1992,2003,11,3.2
Latrell Sprewell ,962,24,13,1992,2004,12,5.7
Latrell Sprewell ,962,24,13,1992,2005,13,1.9
Lavor Postell ,963,39,3,2000,2001,1,-0.1
Lavor Postell ,963,39,3,2000,2002,2,-0.1
Lavor Postell ,963,39,3,2000,2003,3,-0.1
Lavoy Allen ,964,50,5,2011,2012,1,1.6
Lavoy Allen ,964,50,5,2011,2013,2,2.5
Lavoy Allen ,964,50,5,2011,2014,3,1.5
Lavoy Allen ,964,50,5,2011,2015,4,2.8
Lavoy Allen ,964,50,5,2011,2016,5,3.7
Lawrence Moten ,965,36,3,1995,1996,1,0.6
Lawrence Moten ,965,36,3,1995,1997,2,-0.4
Lawrence Moten ,965,36,3,1995,1998,3,-0.1
Lazar Hayward ,966,30,3,2010,2011,1,0.3
Lazar Hayward ,966,30,3,2010,2012,2,-0.1
Lazar Hayward ,966,30,3,2010,2013,3,0.1
Leandro Barbosa ,967,28,13,2003,2004,1,1.9
Leandro Barbosa ,967,28,13,2003,2005,2,1.8
Leandro Barbosa ,967,28,13,2003,2006,3,3.8
Leandro Barbosa ,967,28,13,2003,2007,4,8.2
Leandro Barbosa ,967,28,13,2003,2008,5,5.5
Leandro Barbosa ,967,28,13,2003,2009,6,5
Leandro Barbosa ,967,28,13,2003,2010,7,1.1
Leandro Barbosa ,967,28,13,2003,2011,8,1.5
Leandro Barbosa ,967,28,13,2003,2012,9,1.7
Leandro Barbosa ,967,28,13,2003,2013,10,0.9
Leandro Barbosa ,967,28,13,2003,2014,11,0.4
Leandro Barbosa ,967,28,13,2003,2015,12,2.8
Leandro Barbosa ,967,28,13,2003,2016,13,2.1
LeBron James ,968,1,13,2003,2004,1,5.1
LeBron James ,968,1,13,2003,2005,2,14.3
LeBron James ,968,1,13,2003,2006,3,16.3
LeBron James ,968,1,13,2003,2007,4,13.7
LeBron James ,968,1,13,2003,2008,5,15.2
LeBron James ,968,1,13,2003,2009,6,20.3
LeBron James ,968,1,13,2003,2010,7,18.5
LeBron James ,968,1,13,2003,2011,8,15.6
LeBron James ,968,1,13,2003,2012,9,14.5
LeBron James ,968,1,13,2003,2013,10,19.3
LeBron James ,968,1,13,2003,2014,11,15.9
LeBron James ,968,1,13,2003,2015,12,10.4
LeBron James ,968,1,13,2003,2016,13,13.6
Ledell Eackles ,969,36,7,1988,1989,1,2.1
Ledell Eackles ,969,36,7,1988,1990,2,1
Ledell Eackles ,969,36,7,1988,1991,3,1.2
Ledell Eackles ,969,36,7,1988,1992,4,2
Ledell Eackles ,969,36,7,1988,1995,7,1
Ledell Eackles ,969,36,7,1988,1996,8,2.4
Ledell Eackles ,969,36,7,1988,1998,10,1
Lee Johnson ,970,17,1,1979,1981,2,-0.2
Lee Mayberry ,971,23,7,1992,1993,1,1.8
Lee Mayberry ,971,23,7,1992,1994,2,0.4
Lee Mayberry ,971,23,7,1992,1995,3,1.6
Lee Mayberry ,971,23,7,1992,1996,4,2.1
Lee Mayberry ,971,23,7,1992,1997,5,1.6
Lee Mayberry ,971,23,7,1992,1998,6,0.4
Lee Mayberry ,971,23,7,1992,1999,7,-0.1
Lee Nailon ,972,43,6,1999,2001,2,0.9
Lee Nailon ,972,43,6,1999,2002,3,3.5
Lee Nailon ,972,43,6,1999,2003,4,0.3
Lee Nailon ,972,43,6,1999,2004,5,0.7
Lee Nailon ,972,43,6,1999,2005,6,2.2
Lee Nailon ,972,43,6,1999,2006,7,0.5
Leo Rautins ,973,17,2,1983,1984,1,-0.1
Leo Rautins ,973,17,2,1983,1985,2,0
Leon Powe ,974,49,5,2006,2007,1,1.7
Leon Powe ,974,49,5,2006,2008,2,4.3
Leon Powe ,974,49,5,2006,2009,3,4.9
Leon Powe ,974,49,5,2006,2010,4,0.5
Leon Powe ,974,49,5,2006,2011,5,0.6
Leon Smith ,975,29,2,1999,2002,3,0.2
Leon Smith ,975,29,2,1999,2004,5,0
Leon Wood ,976,10,6,1984,1985,1,-0.2
Leon Wood ,976,10,6,1984,1986,2,1.9
Leon Wood ,976,10,6,1984,1987,3,2
Leon Wood ,976,10,6,1984,1988,4,2.2
Leon Wood ,976,10,6,1984,1990,6,0.3
Leon Wood ,976,10,6,1984,1991,7,0.6
LeRon Ellis ,977,22,3,1991,1992,1,-0.2
LeRon Ellis ,977,22,3,1991,1994,3,1.6
LeRon Ellis ,977,22,3,1991,1996,5,-0.1
Leroy Combs ,978,26,1,1983,1984,1,0.4
Les Jepsen ,979,28,2,1990,1991,1,0
Les Jepsen ,979,28,2,1990,1992,2,0.1
Lester Conner ,980,14,12,1982,1983,1,2.7
Lester Conner ,980,14,12,1982,1984,2,5.9
Lester Conner ,980,14,12,1982,1985,3,2.8
Lester Conner ,980,14,12,1982,1986,4,0.5
Lester Conner ,980,14,12,1982,1988,6,0.7
Lester Conner ,980,14,12,1982,1989,7,6.2
Lester Conner ,980,14,12,1982,1990,8,3.7
Lester Conner ,980,14,12,1982,1991,9,2.1
Lester Conner ,980,14,12,1982,1992,10,2.7
Lester Conner ,980,14,12,1982,1993,11,0.8
Lester Conner ,980,14,12,1982,1994,12,0.3
Lester Conner ,980,14,12,1982,1995,13,0
Linas Kleiza ,981,27,7,2005,2006,1,1.2
Linas Kleiza ,981,27,7,2005,2007,2,2.8
Linas Kleiza ,981,27,7,2005,2008,3,4.7
Linas Kleiza ,981,27,7,2005,2009,4,3.6
Linas Kleiza ,981,27,7,2005,2011,6,-0.3
Linas Kleiza ,981,27,7,2005,2012,7,1.5
Linas Kleiza ,981,27,7,2005,2013,8,0.1
Lindsey Hunter ,982,10,17,1993,1994,1,-0.8
Lindsey Hunter ,982,10,17,1993,1995,2,-0.3
Lindsey Hunter ,982,10,17,1993,1996,3,3.9
Lindsey Hunter ,982,10,17,1993,1997,4,6.4
Lindsey Hunter ,982,10,17,1993,1998,5,4
Lindsey Hunter ,982,10,17,1993,1999,6,4
Lindsey Hunter ,982,10,17,1993,2000,7,5.6
Lindsey Hunter ,982,10,17,1993,2001,8,4.6
Lindsey Hunter ,982,10,17,1993,2002,9,2
Lindsey Hunter ,982,10,17,1993,2003,10,-0.6
Lindsey Hunter ,982,10,17,1993,2004,11,0.9
Lindsey Hunter ,982,10,17,1993,2005,12,1.4
Lindsey Hunter ,982,10,17,1993,2006,13,0.5
Lindsey Hunter ,982,10,17,1993,2007,14,1.3
Lindsey Hunter ,982,10,17,1993,2008,15,0.2
Lindsey Hunter ,982,10,17,1993,2009,16,0
Lindsey Hunter ,982,10,17,1993,2010,17,-0.3
Linton Townes ,983,33,3,1982,1983,1,0.7
Linton Townes ,983,33,3,1982,1984,2,0
Linton Townes ,983,33,3,1982,1985,3,-0.1
Lionel Chalmers ,984,33,1,2004,2005,1,-0.2
Lionel Simmons ,985,7,7,1990,1991,1,2.7
Lionel Simmons ,985,7,7,1990,1992,2,4.3
Lionel Simmons ,985,7,7,1990,1993,3,3.8
Lionel Simmons ,985,7,7,1990,1994,4,3.8
Lionel Simmons ,985,7,7,1990,1995,5,0.9
Lionel Simmons ,985,7,7,1990,1996,6,1.1
Lionel Simmons ,985,7,7,1990,1997,7,0.3
Litterial Green ,986,39,5,1992,1993,1,0.8
Litterial Green ,986,39,5,1992,1994,2,0.1
Litterial Green ,986,39,5,1992,1997,5,0.8
Litterial Green ,986,39,5,1992,1998,6,-0.1
Litterial Green ,986,39,5,1992,1999,7,0
Lonny Baxter ,987,43,4,2002,2003,1,0.9
Lonny Baxter ,987,43,4,2002,2004,2,1.5
Lonny Baxter ,987,43,4,2002,2005,3,-0.2
Lonny Baxter ,987,43,4,2002,2006,4,0.7
Loren Meyer ,988,24,3,1995,1996,1,1.1
Loren Meyer ,988,24,3,1995,1997,2,-0.3
Loren Meyer ,988,24,3,1995,1999,4,-0.3
Loren Woods ,989,45,6,2001,2002,1,0.5
Loren Woods ,989,45,6,2001,2003,2,0.4
Loren Woods ,989,45,6,2001,2004,3,1.1
Loren Woods ,989,45,6,2001,2005,4,0.7
Loren Woods ,989,45,6,2001,2006,5,0.4
Loren Woods ,989,45,6,2001,2008,7,0.1
Lorenzen Wright ,990,7,13,1996,1997,1,3.2
Lorenzen Wright ,990,7,13,1996,1998,2,3.1
Lorenzen Wright ,990,7,13,1996,1999,3,2.2
Lorenzen Wright ,990,7,13,1996,2000,4,2.2
Lorenzen Wright ,990,7,13,1996,2001,5,3.2
Lorenzen Wright ,990,7,13,1996,2002,6,1.4
Lorenzen Wright ,990,7,13,1996,2003,7,2.5
Lorenzen Wright ,990,7,13,1996,2004,8,3.2
Lorenzen Wright ,990,7,13,1996,2005,9,5.2
Lorenzen Wright ,990,7,13,1996,2006,10,3.7
Lorenzen Wright ,990,7,13,1996,2007,11,0.7
Lorenzen Wright ,990,7,13,1996,2008,12,0
Lorenzen Wright ,990,7,13,1996,2009,13,-0.1
Lorenzo Charles ,991,41,1,1985,1986,1,0.5
Lou Roe ,992,30,2,1995,1996,1,0.4
Lou Roe ,992,30,2,1995,1997,2,-0.4
Louis Orr ,993,29,8,1980,1981,1,4.3
Louis Orr ,993,29,8,1980,1982,2,4.3
Louis Orr ,993,29,8,1980,1983,3,3.8
Louis Orr ,993,29,8,1980,1984,4,3.5
Louis Orr ,993,29,8,1980,1985,5,4.8
Louis Orr ,993,29,8,1980,1986,6,3.7
Louis Orr ,993,29,8,1980,1987,7,1.5
Louis Orr ,993,29,8,1980,1988,8,-0.2
Loy Vaught ,994,13,11,1990,1991,1,2.2
Loy Vaught ,994,13,11,1990,1992,2,4.1
Loy Vaught ,994,13,11,1990,1993,3,4.2
Loy Vaught ,994,13,11,1990,1994,4,5.5
Loy Vaught ,994,13,11,1990,1995,5,5.5
Loy Vaught ,994,13,11,1990,1996,6,6.3
Loy Vaught ,994,13,11,1990,1997,7,6.3
Loy Vaught ,994,13,11,1990,1998,8,-0.2
Loy Vaught ,994,13,11,1990,1999,9,0.5
Loy Vaught ,994,13,11,1990,2000,10,0.2
Loy Vaught ,994,13,11,1990,2001,11,1
Luc Longley ,995,7,10,1991,1992,1,0.2
Luc Longley ,995,7,10,1991,1993,2,0.2
Luc Longley ,995,7,10,1991,1994,3,2.2
Luc Longley ,995,7,10,1991,1995,4,1.8
Luc Longley ,995,7,10,1991,1996,5,3.5
Luc Longley ,995,7,10,1991,1997,6,3.1
Luc Longley ,995,7,10,1991,1998,7,3.4
Luc Longley ,995,7,10,1991,1999,8,1.8
Luc Longley ,995,7,10,1991,2000,9,1.3
Luc Longley ,995,7,10,1991,2001,10,0
Luc Mbah a Moute ,996,37,8,2008,2009,1,4
Luc Mbah a Moute ,996,37,8,2008,2010,2,4.7
Luc Mbah a Moute ,996,37,8,2008,2011,3,4.8
Luc Mbah a Moute ,996,37,8,2008,2012,4,2.4
Luc Mbah a Moute ,996,37,8,2008,2013,5,0.5
Luc Mbah a Moute ,996,37,8,2008,2014,6,1
Luc Mbah a Moute ,996,37,8,2008,2015,7,1.1
Luc Mbah a Moute ,996,37,8,2008,2016,8,1.6
Lucas Nogueira ,997,16,2,2013,2015,2,0
Lucas Nogueira ,997,16,2,2013,2016,3,0.7
Lucious Harris ,998,28,12,1993,1994,1,0.6
Lucious Harris ,998,28,12,1993,1995,2,4.1
Lucious Harris ,998,28,12,1993,1996,3,2.1
Lucious Harris ,998,28,12,1993,1997,4,0.4
Lucious Harris ,998,28,12,1993,1998,5,1.1
Lucious Harris ,998,28,12,1993,1999,6,0.8
Lucious Harris ,998,28,12,1993,2000,7,2.8
Lucious Harris ,998,28,12,1993,2001,8,3.1
Lucious Harris ,998,28,12,1993,2002,9,5.1
Lucious Harris ,998,28,12,1993,2003,10,4.7
Lucious Harris ,998,28,12,1993,2004,11,2.5
Lucious Harris ,998,28,12,1993,2005,12,1.3
Luke Babbitt ,999,16,6,2010,2011,1,-0.4
Luke Babbitt ,999,16,6,2010,2012,2,0.7
Luke Babbitt ,999,16,6,2010,2013,3,0.7
Luke Babbitt ,999,16,6,2010,2014,4,0.7
Luke Babbitt ,999,16,6,2010,2015,5,1.6
Luke Babbitt ,999,16,6,2010,2016,6,1.1
Luke Jackson ,1000,10,4,2004,2005,1,0.1
Luke Jackson ,1000,10,4,2004,2006,2,0
Luke Jackson ,1000,10,4,2004,2007,3,0.1
Luke Jackson ,1000,10,4,2004,2008,4,0
Luke Ridnour ,1001,14,12,2003,2004,1,1.2
Luke Ridnour ,1001,14,12,2003,2005,2,5.4
Luke Ridnour ,1001,14,12,2003,2006,3,4.4
Luke Ridnour ,1001,14,12,2003,2007,4,2.3
Luke Ridnour ,1001,14,12,2003,2008,5,0.9
Luke Ridnour ,1001,14,12,2003,2009,6,3.4
Luke Ridnour ,1001,14,12,2003,2010,7,6.2
Luke Ridnour ,1001,14,12,2003,2011,8,4
Luke Ridnour ,1001,14,12,2003,2012,9,3.3
Luke Ridnour ,1001,14,12,2003,2013,10,4.3
Luke Ridnour ,1001,14,12,2003,2014,11,0.1
Luke Ridnour ,1001,14,12,2003,2015,12,0.6
Luke Walton ,1002,32,10,2003,2004,1,1.6
Luke Walton ,1002,32,10,2003,2005,2,0.5
Luke Walton ,1002,32,10,2003,2006,3,2
Luke Walton ,1002,32,10,2003,2007,4,3.8
Luke Walton ,1002,32,10,2003,2008,5,3.2
Luke Walton ,1002,32,10,2003,2009,6,2
Luke Walton ,1002,32,10,2003,2010,7,0.3
Luke Walton ,1002,32,10,2003,2011,8,-0.2
Luke Walton ,1002,32,10,2003,2012,9,-0.4
Luke Walton ,1002,32,10,2003,2013,10,0.8
Luol Deng ,1003,7,12,2004,2005,1,3
Luol Deng ,1003,7,12,2004,2006,2,6.5
Luol Deng ,1003,7,12,2004,2007,3,11.3
Luol Deng ,1003,7,12,2004,2008,4,4.4
Luol Deng ,1003,7,12,2004,2009,5,3
Luol Deng ,1003,7,12,2004,2010,6,5.9
Luol Deng ,1003,7,12,2004,2011,7,9.9
Luol Deng ,1003,7,12,2004,2012,8,5.8
Luol Deng ,1003,7,12,2004,2013,9,6.3
Luol Deng ,1003,7,12,2004,2014,10,4.5
Luol Deng ,1003,7,12,2004,2015,11,5.4
Luol Deng ,1003,7,12,2004,2016,12,6.4
Luther Head ,1004,24,6,2005,2006,1,3.5
Luther Head ,1004,24,6,2005,2007,2,5.7
Luther Head ,1004,24,6,2005,2008,3,3.5
Luther Head ,1004,24,6,2005,2009,4,0.6
Luther Head ,1004,24,6,2005,2010,5,0.6
Luther Head ,1004,24,6,2005,2011,6,0.9
Luther Wright ,1005,18,1,1993,1994,1,-0.1
Maciej Lampe ,1006,30,3,2003,2004,1,0.1
Maciej Lampe ,1006,30,3,2003,2005,2,-0.1
Maciej Lampe ,1006,30,3,2003,2006,3,-0.2
Mahmoud Abdul-Rauf ,1007,3,9,1990,1991,1,-1
Mahmoud Abdul-Rauf ,1007,3,9,1990,1992,2,0.6
Mahmoud Abdul-Rauf ,1007,3,9,1990,1993,3,5.1
Mahmoud Abdul-Rauf ,1007,3,9,1990,1994,4,6.8
Mahmoud Abdul-Rauf ,1007,3,9,1990,1995,5,5
Mahmoud Abdul-Rauf ,1007,3,9,1990,1996,6,5.5
Mahmoud Abdul-Rauf ,1007,3,9,1990,1997,7,2.7
Mahmoud Abdul-Rauf ,1007,3,9,1990,1998,8,-0.3
Mahmoud Abdul-Rauf ,1007,3,9,1990,2001,11,0.7
Malcolm Lee ,1008,43,3,2011,2012,1,0.1
Malcolm Lee ,1008,43,3,2011,2013,2,0.4
Malcolm Lee ,1008,43,3,2011,2015,4,0
Malcolm Mackey ,1009,27,1,1993,1994,1,0.1
Malik Hairston ,1010,48,2,2008,2009,1,0.1
Malik Hairston ,1010,48,2,2008,2010,2,0.7
Malik Rose ,1011,44,13,1996,1997,1,1.1
Malik Rose ,1011,44,13,1996,1998,2,0.4
Malik Rose ,1011,44,13,1996,1999,3,2.6
Malik Rose ,1011,44,13,1996,2000,4,3.4
Malik Rose ,1011,44,13,1996,2001,5,3.3
Malik Rose ,1011,44,13,1996,2002,6,4.4
Malik Rose ,1011,44,13,1996,2003,7,5.2
Malik Rose ,1011,44,13,1996,2004,8,3.8
Malik Rose ,1011,44,13,1996,2005,9,2.6
Malik Rose ,1011,44,13,1996,2006,10,0.5
Malik Rose ,1011,44,13,1996,2007,11,0.1
Malik Rose ,1011,44,13,1996,2008,12,-0.5
Malik Rose ,1011,44,13,1996,2009,13,-0.4
Malik Sealy ,1012,14,8,1992,1993,1,0.2
Malik Sealy ,1012,14,8,1992,1994,2,0.6
Malik Sealy ,1012,14,8,1992,1995,3,2.1
Malik Sealy ,1012,14,8,1992,1996,4,1.2
Malik Sealy ,1012,14,8,1992,1997,5,3.2
Malik Sealy ,1012,14,8,1992,1998,6,3.2
Malik Sealy ,1012,14,8,1992,1999,7,1.1
Malik Sealy ,1012,14,8,1992,2000,8,5.5
Mamadou N'Diaye ,1013,26,5,2000,2001,1,0
Mamadou N'Diaye ,1013,26,5,2000,2002,2,0.3
Mamadou N'Diaye ,1013,26,5,2000,2003,3,0.6
Mamadou N'Diaye ,1013,26,5,2000,2004,4,0.8
Mamadou N'Diaye ,1013,26,5,2000,2005,5,0.2
Manute Bol ,1014,31,10,1985,1986,1,3.9
Manute Bol ,1014,31,10,1985,1987,2,2.4
Manute Bol ,1014,31,10,1985,1988,3,2
Manute Bol ,1014,31,10,1985,1989,4,1.7
Manute Bol ,1014,31,10,1985,1990,5,0
Manute Bol ,1014,31,10,1985,1991,6,1.3
Manute Bol ,1014,31,10,1985,1992,7,0.8
Manute Bol ,1014,31,10,1985,1993,8,0.2
Manute Bol ,1014,31,10,1985,1994,9,-0.2
Manute Bol ,1014,31,10,1985,1995,10,0.1
Marc Gasol ,1015,48,8,2007,2009,2,6.4
Marc Gasol ,1015,48,8,2007,2010,3,8.4
Marc Gasol ,1015,48,8,2007,2011,4,7.9
Marc Gasol ,1015,48,8,2007,2012,5,8.2
Marc Gasol ,1015,48,8,2007,2013,6,11.5
Marc Gasol ,1015,48,8,2007,2014,7,5.6
Marc Gasol ,1015,48,8,2007,2015,8,10.2
Marc Gasol ,1015,48,8,2007,2016,9,3.7
Marc Jackson ,1016,37,7,1997,2001,4,2.6
Marc Jackson ,1016,37,7,1997,2002,5,0.6
Marc Jackson ,1016,37,7,1997,2003,6,2
Marc Jackson ,1016,37,7,1997,2004,7,1.3
Marc Jackson ,1016,37,7,1997,2005,8,4.6
Marc Jackson ,1016,37,7,1997,2006,9,1.2
Marc Jackson ,1016,37,7,1997,2007,10,0.7
Marco Belinelli ,1017,18,9,2007,2008,1,0
Marco Belinelli ,1017,18,9,2007,2009,2,0.5
Marco Belinelli ,1017,18,9,2007,2010,3,1.2
Marco Belinelli ,1017,18,9,2007,2011,4,3.4
Marco Belinelli ,1017,18,9,2007,2012,5,2.9
Marco Belinelli ,1017,18,9,2007,2013,6,3
Marco Belinelli ,1017,18,9,2007,2014,7,5.9
Marco Belinelli ,1017,18,9,2007,2015,8,2.9
Marco Belinelli ,1017,18,9,2007,2016,9,0.5
Marcus Banks ,1018,13,8,2003,2004,1,0.7
Marcus Banks ,1018,13,8,2003,2005,2,1.9
Marcus Banks ,1018,13,8,2003,2006,3,2.3
Marcus Banks ,1018,13,8,2003,2007,4,0.4
Marcus Banks ,1018,13,8,2003,2008,5,0.8
Marcus Banks ,1018,13,8,2003,2009,6,0
Marcus Banks ,1018,13,8,2003,2010,7,0.5
Marcus Banks ,1018,13,8,2003,2011,8,0
Marcus Brown ,1019,46,2,1996,1997,1,0.4
Marcus Brown ,1019,46,2,1996,2000,4,-0.1
Marcus Camby ,1020,2,17,1996,1997,1,3.7
Marcus Camby ,1020,2,17,1996,1998,2,0.9
Marcus Camby ,1020,2,17,1996,1999,3,3.5
Marcus Camby ,1020,2,17,1996,2000,4,5.9
Marcus Camby ,1020,2,17,1996,2001,5,10.3
Marcus Camby ,1020,2,17,1996,2002,6,2.1
Marcus Camby ,1020,2,17,1996,2003,7,1.5
Marcus Camby ,1020,2,17,1996,2004,8,6.9
Marcus Camby ,1020,2,17,1996,2005,9,5.8
Marcus Camby ,1020,2,17,1996,2006,10,5.5
Marcus Camby ,1020,2,17,1996,2007,11,7.6
Marcus Camby ,1020,2,17,1996,2008,12,8.5
Marcus Camby ,1020,2,17,1996,2009,13,5.2
Marcus Camby ,1020,2,17,1996,2010,14,6.8
Marcus Camby ,1020,2,17,1996,2011,15,3.7
Marcus Camby ,1020,2,17,1996,2012,16,3.6
Marcus Camby ,1020,2,17,1996,2013,17,0
Marcus Fizer ,1021,4,6,2000,2001,1,-0.7
Marcus Fizer ,1021,4,6,2000,2002,2,1.1
Marcus Fizer ,1021,4,6,2000,2003,3,1.4
Marcus Fizer ,1021,4,6,2000,2004,4,0.5
Marcus Fizer ,1021,4,6,2000,2005,5,0.4
Marcus Fizer ,1021,4,6,2000,2006,6,0
Marcus Haislip ,1022,13,4,2002,2003,1,0
Marcus Haislip ,1022,13,4,2002,2004,2,0.6
Marcus Haislip ,1022,13,4,2002,2005,3,-0.2
Marcus Haislip ,1022,13,4,2002,2010,8,0.1
Marcus Liberty ,1023,42,4,1990,1991,1,-0.1
Marcus Liberty ,1023,42,4,1990,1992,2,2.4
Marcus Liberty ,1023,42,4,1990,1993,3,2.2
Marcus Liberty ,1023,42,4,1990,1994,4,-0.5
Marcus Morris ,1024,14,5,2011,2012,1,-0.2
Marcus Morris ,1024,14,5,2011,2013,2,1.8
Marcus Morris ,1024,14,5,2011,2014,3,4.2
Marcus Morris ,1024,14,5,2011,2015,4,4
Marcus Morris ,1024,14,5,2011,2016,5,5.4
Marcus Smart ,1025,6,2,2014,2015,1,2.9
Marcus Smart ,1025,6,2,2014,2016,2,2.9
Marcus Thornton ,1026,43,7,2009,2010,1,4
Marcus Thornton ,1026,43,7,2009,2011,2,3.5
Marcus Thornton ,1026,43,7,2009,2012,3,3.8
Marcus Thornton ,1026,43,7,2009,2013,4,3.2
Marcus Thornton ,1026,43,7,2009,2014,5,2
Marcus Thornton ,1026,43,7,2009,2015,6,1.2
Marcus Thornton ,1026,43,7,2009,2016,7,1.7
Marcus Vinicius ,1027,43,2,2006,2007,1,0.1
Marcus Vinicius ,1027,43,2,2006,2008,2,0.1
Marcus Williams ,1028,33,2,2007,2008,1,-0.1
Marcus Williams ,1028,33,2,2007,2009,2,0
Marcus Williams J,1029,22,4,2006,2007,1,-0.1
Marcus Williams J,1029,22,4,2006,2008,2,0.2
Marcus Williams J,1029,22,4,2006,2009,3,-0.1
Marcus Williams J,1029,22,4,2006,2010,4,0
Mardy Collins ,1030,29,4,2006,2007,1,0
Mardy Collins ,1030,29,4,2006,2008,2,-1
Mardy Collins ,1030,29,4,2006,2009,3,-0.1
Mardy Collins ,1030,29,4,2006,2010,4,-0.5
Mario Bennett ,1031,27,4,1995,1996,1,0.5
Mario Bennett ,1031,27,4,1995,1998,3,1.5
Mario Bennett ,1031,27,4,1995,1999,4,0
Mario Bennett ,1031,27,4,1995,2000,5,-0.1
Mario Chalmers ,1032,34,8,2008,2009,1,5.2
Mario Chalmers ,1032,34,8,2008,2010,2,2.7
Mario Chalmers ,1032,34,8,2008,2011,3,2.9
Mario Chalmers ,1032,34,8,2008,2012,4,4.3
Mario Chalmers ,1032,34,8,2008,2013,5,5.2
Mario Chalmers ,1032,34,8,2008,2014,6,4.8
Mario Chalmers ,1032,34,8,2008,2015,7,2.8
Mario Chalmers ,1032,34,8,2008,2016,8,3.8
Mario Hezonja ,1033,5,1,2015,2016,1,0.9
Mario Kasun ,1034,40,2,2002,2005,3,0.6
Mario Kasun ,1034,40,2,2002,2006,4,0.3
Mark Acres ,1035,40,6,1985,1988,3,2.2
Mark Acres ,1035,40,6,1985,1989,4,0.9
Mark Acres ,1035,40,6,1985,1990,5,1.6
Mark Acres ,1035,40,6,1985,1991,6,2.5
Mark Acres ,1035,40,6,1985,1992,7,1.9
Mark Acres ,1035,40,6,1985,1993,8,0.3
Mark Aguirre ,1036,1,13,1981,1982,1,1.9
Mark Aguirre ,1036,1,13,1981,1983,2,6.9
Mark Aguirre ,1036,1,13,1981,1984,3,9
Mark Aguirre ,1036,1,13,1981,1985,4,7.2
Mark Aguirre ,1036,1,13,1981,1986,5,4.7
Mark Aguirre ,1036,1,13,1981,1987,6,8.9
Mark Aguirre ,1036,1,13,1981,1988,7,8.8
Mark Aguirre ,1036,1,13,1981,1989,8,4.5
Mark Aguirre ,1036,1,13,1981,1990,9,5.7
Mark Aguirre ,1036,1,13,1981,1991,10,5.5
Mark Aguirre ,1036,1,13,1981,1992,11,2.2
Mark Aguirre ,1036,1,13,1981,1993,12,1.8
Mark Aguirre ,1036,1,13,1981,1994,13,0.9
Mark Alarie ,1037,18,5,1986,1987,1,1.5
Mark Alarie ,1037,18,5,1986,1988,2,0.9
Mark Alarie ,1037,18,5,1986,1989,3,2.2
Mark Alarie ,1037,18,5,1986,1990,4,3.1
Mark Alarie ,1037,18,5,1986,1991,5,0.6
Mark Bryant ,1038,21,15,1988,1989,1,1.1
Mark Bryant ,1038,21,15,1988,1990,2,1
Mark Bryant ,1038,21,15,1988,1991,3,2.1
Mark Bryant ,1038,21,15,1988,1992,4,2.1
Mark Bryant ,1038,21,15,1988,1993,5,3.2
Mark Bryant ,1038,21,15,1988,1994,6,2.3
Mark Bryant ,1038,21,15,1988,1995,7,1.6
Mark Bryant ,1038,21,15,1988,1996,8,3.6
Mark Bryant ,1038,21,15,1988,1997,9,2.3
Mark Bryant ,1038,21,15,1988,1998,10,2.5
Mark Bryant ,1038,21,15,1988,1999,11,1.5
Mark Bryant ,1038,21,15,1988,2000,12,2.4
Mark Bryant ,1038,21,15,1988,2001,13,0
Mark Bryant ,1038,21,15,1988,2002,14,0.6
Mark Bryant ,1038,21,15,1988,2003,15,-0.1
Mark Davis ,1039,48,5,1995,1996,1,-0.1
Mark Davis ,1039,48,5,1995,1997,2,2.3
Mark Davis ,1039,48,5,1995,1998,3,0.2
Mark Davis ,1039,48,5,1995,1999,4,-0.1
Mark Davis ,1039,48,5,1995,2000,5,-0.1
Mark Hendrickson ,1040,31,4,1996,1997,1,0.3
Mark Hendrickson ,1040,31,4,1996,1998,2,0.8
Mark Hendrickson ,1040,31,4,1996,1999,3,0.9
Mark Hendrickson ,1040,31,4,1996,2000,4,0.1
Mark Jackson ,1041,18,17,1987,1988,1,7.6
Mark Jackson ,1041,18,17,1987,1989,2,7.2
Mark Jackson ,1041,18,17,1987,1990,3,3.7
Mark Jackson ,1041,18,17,1987,1991,4,4.2
Mark Jackson ,1041,18,17,1987,1992,5,7.6
Mark Jackson ,1041,18,17,1987,1993,6,7.9
Mark Jackson ,1041,18,17,1987,1994,7,4.1
Mark Jackson ,1041,18,17,1987,1995,8,4.5
Mark Jackson ,1041,18,17,1987,1996,9,7.2
Mark Jackson ,1041,18,17,1987,1997,10,6.1
Mark Jackson ,1041,18,17,1987,1998,11,7.5
Mark Jackson ,1041,18,17,1987,1999,12,3.8
Mark Jackson ,1041,18,17,1987,2000,13,6.7
Mark Jackson ,1041,18,17,1987,2001,14,5.9
Mark Jackson ,1041,18,17,1987,2002,15,6
Mark Jackson ,1041,18,17,1987,2003,16,1.1
Mark Jackson ,1041,18,17,1987,2004,17,0.4
Mark Macon ,1042,8,6,1991,1992,1,-0.8
Mark Macon ,1042,8,6,1991,1993,2,0.5
Mark Macon ,1042,8,6,1991,1994,3,-0.4
Mark Macon ,1042,8,6,1991,1995,4,0.5
Mark Macon ,1042,8,6,1991,1996,5,0.5
Mark Macon ,1042,8,6,1991,1999,8,-0.2
Mark Madsen ,1043,29,9,2000,2001,1,1.1
Mark Madsen ,1043,29,9,2000,2002,2,1.9
Mark Madsen ,1043,29,9,2000,2003,3,1.1
Mark Madsen ,1043,29,9,2000,2004,4,2.7
Mark Madsen ,1043,29,9,2000,2005,5,0.8
Mark Madsen ,1043,29,9,2000,2006,6,0.6
Mark Madsen ,1043,29,9,2000,2007,7,0.4
Mark Madsen ,1043,29,9,2000,2008,8,-0.3
Mark Madsen ,1043,29,9,2000,2009,9,-0.1
Mark McNamara ,1044,22,8,1982,1983,1,-0.2
Mark McNamara ,1044,22,8,1982,1984,2,1.2
Mark McNamara ,1044,22,8,1982,1985,3,0.4
Mark McNamara ,1044,22,8,1982,1987,5,0
Mark McNamara ,1044,22,8,1982,1988,6,0.6
Mark McNamara ,1044,22,8,1982,1989,7,0.7
Mark McNamara ,1044,22,8,1982,1990,8,0.1
Mark McNamara ,1044,22,8,1982,1991,9,0
Mark Price ,1045,25,12,1986,1987,1,1.1
Mark Price ,1045,25,12,1986,1988,2,7.8
Mark Price ,1045,25,12,1986,1989,3,11.3
Mark Price ,1045,25,12,1986,1990,4,10.1
Mark Price ,1045,25,12,1986,1991,5,2
Mark Price ,1045,25,12,1986,1992,6,9.1
Mark Price ,1045,25,12,1986,1993,7,9.8
Mark Price ,1045,25,12,1986,1994,8,10
Mark Price ,1045,25,12,1986,1995,9,4.2
Mark Price ,1045,25,12,1986,1996,10,0
Mark Price ,1045,25,12,1986,1997,11,4
Mark Price ,1045,25,12,1986,1998,12,1.7
Mark Randall ,1046,26,4,1991,1992,1,0.5
Mark Randall ,1046,26,4,1991,1993,2,0.3
Mark Randall ,1046,26,4,1991,1994,3,0.2
Mark Randall ,1046,26,4,1991,1995,4,0
Mark West ,1047,30,17,1983,1984,1,-0.1
Mark West ,1047,30,17,1983,1985,2,1.1
Mark West ,1047,30,17,1983,1986,3,0.9
Mark West ,1047,30,17,1983,1987,4,1.9
Mark West ,1047,30,17,1983,1988,5,3.1
Mark West ,1047,30,17,1983,1989,6,5.5
Mark West ,1047,30,17,1983,1990,7,8.2
Mark West ,1047,30,17,1983,1991,8,6.5
Mark West ,1047,30,17,1983,1992,9,3.9
Mark West ,1047,30,17,1983,1993,10,3.4
Mark West ,1047,30,17,1983,1994,11,2.4
Mark West ,1047,30,17,1983,1995,12,1.8
Mark West ,1047,30,17,1983,1996,13,0.8
Mark West ,1047,30,17,1983,1997,14,1.6
Mark West ,1047,30,17,1983,1998,15,0
Mark West ,1047,30,17,1983,1999,16,0.7
Mark West ,1047,30,17,1983,2000,17,0.2
Markel Brown ,1048,44,2,2014,2015,1,0.5
Markel Brown ,1048,44,2,2014,2016,2,0.6
Markieff Morris ,1049,13,5,2011,2012,1,1.5
Markieff Morris ,1049,13,5,2011,2013,2,1.7
Markieff Morris ,1049,13,5,2011,2014,3,6.4
Markieff Morris ,1049,13,5,2011,2015,4,4.6
Markieff Morris ,1049,13,5,2011,2016,5,0.5
Marko Jaric ,1050,30,7,2000,2003,3,1.9
Marko Jaric ,1050,30,7,2000,2004,4,1.5
Marko Jaric ,1050,30,7,2000,2005,5,2.8
Marko Jaric ,1050,30,7,2000,2006,6,2.3
Marko Jaric ,1050,30,7,2000,2007,7,1.5
Marko Jaric ,1050,30,7,2000,2008,8,2.4
Marko Jaric ,1050,30,7,2000,2009,9,-0.4
Marko Milic ,1051,33,2,1997,1998,1,0.3
Marko Milic ,1051,33,2,1997,1999,2,-0.1
Marlon Maxey ,1052,28,2,1992,1993,1,0.9
Marlon Maxey ,1052,28,2,1992,1994,2,1.7
Marquis Teague ,1053,29,2,2012,2013,1,-0.3
Marquis Teague ,1053,29,2,2012,2014,2,-0.5
Marreese Speights ,1054,16,8,2008,2009,1,3.8
Marreese Speights ,1054,16,8,2008,2010,2,2.1
Marreese Speights ,1054,16,8,2008,2011,3,1.7
Marreese Speights ,1054,16,8,2008,2012,4,2.7
Marreese Speights ,1054,16,8,2008,2013,5,2.8
Marreese Speights ,1054,16,8,2008,2014,6,2.1
Marreese Speights ,1054,16,8,2008,2015,7,4
Marreese Speights ,1054,16,8,2008,2016,8,1.8
MarShon Brooks ,1055,25,3,2011,2012,1,0.8
MarShon Brooks ,1055,25,3,2011,2013,2,1.3
MarShon Brooks ,1055,25,3,2011,2014,3,0.4
Martell Webster ,1056,6,10,2005,2006,1,0.9
Martell Webster ,1056,6,10,2005,2007,2,1.3
Martell Webster ,1056,6,10,2005,2008,3,3.5
Martell Webster ,1056,6,10,2005,2009,4,0
Martell Webster ,1056,6,10,2005,2010,5,4.4
Martell Webster ,1056,6,10,2005,2011,6,1.8
Martell Webster ,1056,6,10,2005,2012,7,1.5
Martell Webster ,1056,6,10,2005,2013,8,6.3
Martell Webster ,1056,6,10,2005,2014,9,5
Martell Webster ,1056,6,10,2005,2015,10,0
Martin Lewis ,1057,50,2,1995,1996,1,0
Martin Lewis ,1057,50,2,1995,1997,2,0.1
Martin Muursepp ,1058,25,2,1996,1997,1,0.6
Martin Muursepp ,1058,25,2,1996,1998,2,1.4
Marty Byrnes ,1059,19,4,1978,1979,1,0.9
Marty Byrnes ,1059,19,4,1978,1980,2,0
Marty Byrnes ,1059,19,4,1978,1981,3,2.3
Marty Byrnes ,1059,19,4,1978,1983,5,1
Martynas Andriuskevicius ,1060,44,1,2005,2006,1,0
Marvin Williams ,1061,2,11,2005,2006,1,2.8
Marvin Williams ,1061,2,11,2005,2007,2,2.3
Marvin Williams ,1061,2,11,2005,2008,3,5.7
Marvin Williams ,1061,2,11,2005,2009,4,6.1
Marvin Williams ,1061,2,11,2005,2010,5,5.7
Marvin Williams ,1061,2,11,2005,2011,6,4
Marvin Williams ,1061,2,11,2005,2012,7,4.9
Marvin Williams ,1061,2,11,2005,2013,8,2.3
Marvin Williams ,1061,2,11,2005,2014,9,2.9
Marvin Williams ,1061,2,11,2005,2015,10,4.3
Marvin Williams ,1061,2,11,2005,2016,11,7.8
Mason Plumlee ,1062,22,3,2013,2014,1,4.7
Mason Plumlee ,1062,22,3,2013,2015,2,4.8
Mason Plumlee ,1062,22,3,2013,2016,3,6.1
Mateen Cleaves ,1063,14,6,2000,2001,1,-0.1
Mateen Cleaves ,1063,14,6,2000,2002,2,-0.3
Mateen Cleaves ,1063,14,6,2000,2003,3,-0.4
Mateen Cleaves ,1063,14,6,2000,2004,4,0
Mateen Cleaves ,1063,14,6,2000,2005,5,0
Mateen Cleaves ,1063,14,6,2000,2006,6,0
Matt Barnes ,1064,45,13,2002,2004,2,0.7
Matt Barnes ,1064,45,13,2002,2005,3,0.4
Matt Barnes ,1064,45,13,2002,2006,4,1
Matt Barnes ,1064,45,13,2002,2007,5,3.7
Matt Barnes ,1064,45,13,2002,2008,6,2.3
Matt Barnes ,1064,45,13,2002,2009,7,3
Matt Barnes ,1064,45,13,2002,2010,8,5.9
Matt Barnes ,1064,45,13,2002,2011,9,3
Matt Barnes ,1064,45,13,2002,2012,10,4.3
Matt Barnes ,1064,45,13,2002,2013,11,6.3
Matt Barnes ,1064,45,13,2002,2014,12,3.5
Matt Barnes ,1064,45,13,2002,2015,13,4.3
Matt Barnes ,1064,45,13,2002,2016,14,2.6
Matt Bonner ,1065,45,12,2003,2005,2,4.2
Matt Bonner ,1065,45,12,2003,2006,3,4.1
Matt Bonner ,1065,45,12,2003,2007,4,2.2
Matt Bonner ,1065,45,12,2003,2008,5,2
Matt Bonner ,1065,45,12,2003,2009,6,6.8
Matt Bonner ,1065,45,12,2003,2010,7,3.7
Matt Bonner ,1065,45,12,2003,2011,8,4.4
Matt Bonner ,1065,45,12,2003,2012,9,4
Matt Bonner ,1065,45,12,2003,2013,10,2.5
Matt Bonner ,1065,45,12,2003,2014,11,1.8
Matt Bonner ,1065,45,12,2003,2015,12,2.1
Matt Bonner ,1065,45,12,2003,2016,13,0.8
Matt Fish ,1066,50,3,1992,1995,3,0.2
Matt Fish ,1066,50,3,1992,1996,4,0.4
Matt Fish ,1066,50,3,1992,1997,5,0
Matt Geiger ,1067,42,10,1992,1993,1,1.2
Matt Geiger ,1067,42,10,1992,1994,2,4.5
Matt Geiger ,1067,42,10,1992,1995,3,2.7
Matt Geiger ,1067,42,10,1992,1996,4,4.3
Matt Geiger ,1067,42,10,1992,1997,5,1.9
Matt Geiger ,1067,42,10,1992,1998,6,5.9
Matt Geiger ,1067,42,10,1992,1999,7,4.7
Matt Geiger ,1067,42,10,1992,2000,8,2.6
Matt Geiger ,1067,42,10,1992,2001,9,0.7
Matt Geiger ,1067,42,10,1992,2002,10,-0.1
Matt Harpring ,1068,15,11,1998,1999,1,2.6
Matt Harpring ,1068,15,11,1998,2000,2,0.2
Matt Harpring ,1068,15,11,1998,2001,3,2.6
Matt Harpring ,1068,15,11,1998,2002,4,6.1
Matt Harpring ,1068,15,11,1998,2003,5,8.8
Matt Harpring ,1068,15,11,1998,2004,6,2.8
Matt Harpring ,1068,15,11,1998,2005,7,5.5
Matt Harpring ,1068,15,11,1998,2006,8,4.7
Matt Harpring ,1068,15,11,1998,2007,9,4.7
Matt Harpring ,1068,15,11,1998,2008,10,2.8
Matt Harpring ,1068,15,11,1998,2009,11,1.2
Maurice Ager ,1069,28,4,2006,2007,1,-0.3
Maurice Ager ,1069,28,4,2006,2008,2,-0.4
Maurice Ager ,1069,28,4,2006,2009,3,-0.3
Maurice Ager ,1069,28,4,2006,2011,5,0
Maurice Cheeks ,1070,36,15,1978,1979,1,4.9
Maurice Cheeks ,1070,36,15,1978,1980,2,7.9
Maurice Cheeks ,1070,36,15,1978,1981,3,8.5
Maurice Cheeks ,1070,36,15,1978,1982,4,8.6
Maurice Cheeks ,1070,36,15,1978,1983,5,9.4
Maurice Cheeks ,1070,36,15,1978,1984,6,7.3
Maurice Cheeks ,1070,36,15,1978,1985,7,9
Maurice Cheeks ,1070,36,15,1978,1986,8,10.6
Maurice Cheeks ,1070,36,15,1978,1987,9,7.9
Maurice Cheeks ,1070,36,15,1978,1988,10,8.3
Maurice Cheeks ,1070,36,15,1978,1989,11,5.3
Maurice Cheeks ,1070,36,15,1978,1990,12,7.1
Maurice Cheeks ,1070,36,15,1978,1991,13,5.2
Maurice Cheeks ,1070,36,15,1978,1992,14,2.1
Maurice Cheeks ,1070,36,15,1978,1993,15,1.3
Maurice Harkless ,1071,15,4,2012,2013,1,2.4
Maurice Harkless ,1071,15,4,2012,2014,2,2.8
Maurice Harkless ,1071,15,4,2012,2015,3,0.3
Maurice Harkless ,1071,15,4,2012,2016,4,2.9
Maurice Martin ,1072,16,2,1986,1987,1,-0.2
Maurice Martin ,1072,16,2,1986,1988,2,0
Maurice Taylor ,1073,14,9,1997,1998,1,1.8
Maurice Taylor ,1073,14,9,1997,1999,2,0.7
Maurice Taylor ,1073,14,9,1997,2000,3,-0.3
Maurice Taylor ,1073,14,9,1997,2001,4,3.2
Maurice Taylor ,1073,14,9,1997,2003,6,0.9
Maurice Taylor ,1073,14,9,1997,2004,7,3.7
Maurice Taylor ,1073,14,9,1997,2005,8,0.5
Maurice Taylor ,1073,14,9,1997,2006,9,-0.5
Maurice Taylor ,1073,14,9,1997,2007,10,-0.1
Mehmet Okur ,1074,37,10,2001,2003,2,3.8
Mehmet Okur ,1074,37,10,2001,2004,3,5.9
Mehmet Okur ,1074,37,10,2001,2005,4,7
Mehmet Okur ,1074,37,10,2001,2006,5,9.3
Mehmet Okur ,1074,37,10,2001,2007,6,8.8
Mehmet Okur ,1074,37,10,2001,2008,7,6.7
Mehmet Okur ,1074,37,10,2001,2009,8,7.4
Mehmet Okur ,1074,37,10,2001,2010,9,5.6
Mehmet Okur ,1074,37,10,2001,2011,10,0.2
Mehmet Okur ,1074,37,10,2001,2012,11,0
Melvin Ely ,1075,12,9,2002,2003,1,0.8
Melvin Ely ,1075,12,9,2002,2004,2,0.4
Melvin Ely ,1075,12,9,2002,2005,3,0.1
Melvin Ely ,1075,12,9,2002,2006,4,2
Melvin Ely ,1075,12,9,2002,2007,5,-0.3
Melvin Ely ,1075,12,9,2002,2008,6,0.3
Melvin Ely ,1075,12,9,2002,2009,7,-0.1
Melvin Ely ,1075,12,9,2002,2011,9,0.6
Melvin Ely ,1075,12,9,2002,2014,12,0
Melvin Turpin ,1076,6,5,1984,1985,1,3.1
Melvin Turpin ,1076,6,5,1984,1986,2,6
Melvin Turpin ,1076,6,5,1984,1987,3,0.8
Melvin Turpin ,1076,6,5,1984,1988,4,2.1
Melvin Turpin ,1076,6,5,1984,1990,6,1.8
Metta World Peace ,1077,16,16,1999,2000,1,2.3
Metta World Peace ,1077,16,16,1999,2001,2,1.9
Metta World Peace ,1077,16,16,1999,2002,3,2.7
Metta World Peace ,1077,16,16,1999,2003,4,7.2
Metta World Peace ,1077,16,16,1999,2004,5,8
Metta World Peace ,1077,16,16,1999,2005,6,1.3
Metta World Peace ,1077,16,16,1999,2006,7,3.7
Metta World Peace ,1077,16,16,1999,2007,8,6.7
Metta World Peace ,1077,16,16,1999,2008,9,4.7
Metta World Peace ,1077,16,16,1999,2009,10,5.5
Metta World Peace ,1077,16,16,1999,2010,11,5.3
Metta World Peace ,1077,16,16,1999,2011,12,4.4
Metta World Peace ,1077,16,16,1999,2012,13,2.6
Metta World Peace ,1077,16,16,1999,2013,14,4.6
Metta World Peace ,1077,16,16,1999,2014,15,0.3
Metta World Peace ,1077,16,16,1999,2016,17,0.1
Meyers Leonard ,1078,11,4,2012,2013,1,2.4
Meyers Leonard ,1078,11,4,2012,2014,2,0.6
Meyers Leonard ,1078,11,4,2012,2015,3,2.8
Meyers Leonard ,1078,11,4,2012,2016,4,2.2
Michael Ansley ,1079,37,3,1989,1990,1,3.3
Michael Ansley ,1079,37,3,1989,1991,2,3.1
Michael Ansley ,1079,37,3,1989,1992,3,0
Michael Beasley ,1080,2,8,2008,2009,1,3.4
Michael Beasley ,1080,2,8,2008,2010,2,4.6
Michael Beasley ,1080,2,8,2008,2011,3,1.7
Michael Beasley ,1080,2,8,2008,2012,4,0.5
Michael Beasley ,1080,2,8,2008,2013,5,-1.5
Michael Beasley ,1080,2,8,2008,2014,6,1.6
Michael Beasley ,1080,2,8,2008,2015,7,-0.1
Michael Beasley ,1080,2,8,2008,2016,8,1
Michael Bradley ,1081,17,5,2001,2002,1,0.1
Michael Bradley ,1081,17,5,2001,2003,2,1.5
Michael Bradley ,1081,17,5,2001,2004,3,0
Michael Bradley ,1081,17,5,2001,2005,4,0.2
Michael Bradley ,1081,17,5,2001,2006,5,0.1
Michael Brooks ,1082,9,6,1980,1981,1,4.9
Michael Brooks ,1082,9,6,1980,1982,2,4.5
Michael Brooks ,1082,9,6,1980,1983,3,4.7
Michael Brooks ,1082,9,6,1980,1984,4,2.4
Michael Brooks ,1082,9,6,1980,1987,7,0
Michael Brooks ,1082,9,6,1980,1988,8,0
Michael Cage ,1083,14,15,1984,1985,1,3.2
Michael Cage ,1083,14,15,1984,1986,2,1.7
Michael Cage ,1083,14,15,1984,1987,3,7.2
Michael Cage ,1083,14,15,1984,1988,4,6.7
Michael Cage ,1083,14,15,1984,1989,5,6.7
Michael Cage ,1083,14,15,1984,1990,6,6.8
Michael Cage ,1083,14,15,1984,1991,7,4.3
Michael Cage ,1083,14,15,1984,1992,8,7.6
Michael Cage ,1083,14,15,1984,1993,9,6.2
Michael Cage ,1083,14,15,1984,1994,10,4.9
Michael Cage ,1083,14,15,1984,1995,11,5.8
Michael Cage ,1083,14,15,1984,1996,12,8.1
Michael Cage ,1083,14,15,1984,1997,13,2
Michael Cage ,1083,14,15,1984,1998,14,2.5
Michael Cage ,1083,14,15,1984,2000,16,0.7
Michael Carter-Williams ,1084,11,3,2013,2014,1,1.3
Michael Carter-Williams ,1084,11,3,2013,2015,2,0.8
Michael Carter-Williams ,1084,11,3,2013,2016,3,1.2
Michael Dickerson ,1085,14,5,1998,1999,1,2.2
Michael Dickerson ,1085,14,5,1998,2000,2,5.5
Michael Dickerson ,1085,14,5,1998,2001,3,1.8
Michael Dickerson ,1085,14,5,1998,2002,4,-0.1
Michael Dickerson ,1085,14,5,1998,2003,5,0.1
Michael Doleac ,1086,12,10,1998,1999,1,2.2
Michael Doleac ,1086,12,10,1998,2000,2,3
Michael Doleac ,1086,12,10,1998,2001,3,1.5
Michael Doleac ,1086,12,10,1998,2002,4,0.3
Michael Doleac ,1086,12,10,1998,2003,5,0.3
Michael Doleac ,1086,12,10,1998,2004,6,1.7
Michael Doleac ,1086,12,10,1998,2005,7,1.9
Michael Doleac ,1086,12,10,1998,2006,8,0.6
Michael Doleac ,1086,12,10,1998,2007,9,1.2
Michael Doleac ,1086,12,10,1998,2008,10,0
Michael Finley ,1087,21,15,1995,1996,1,6.3
Michael Finley ,1087,21,15,1995,1997,2,3.9
Michael Finley ,1087,21,15,1995,1998,3,7.5
Michael Finley ,1087,21,15,1995,1999,4,5.4
Michael Finley ,1087,21,15,1995,2000,5,8.3
Michael Finley ,1087,21,15,1995,2001,6,8.5
Michael Finley ,1087,21,15,1995,2002,7,6.3
Michael Finley ,1087,21,15,1995,2003,8,6.7
Michael Finley ,1087,21,15,1995,2004,9,7.6
Michael Finley ,1087,21,15,1995,2005,10,5.5
Michael Finley ,1087,21,15,1995,2006,11,5
Michael Finley ,1087,21,15,1995,2007,12,4.7
Michael Finley ,1087,21,15,1995,2008,13,4.2
Michael Finley ,1087,21,15,1995,2009,14,4.4
Michael Finley ,1087,21,15,1995,2010,15,1
Michael Jackson ,1088,47,3,1986,1988,2,-0.2
Michael Jackson ,1088,47,3,1986,1989,3,0
Michael Jackson ,1088,47,3,1986,1990,4,0
Michael Kidd-Gilchrist ,1089,2,4,2012,2013,1,2.1
Michael Kidd-Gilchrist ,1089,2,4,2012,2014,2,3.1
Michael Kidd-Gilchrist ,1089,2,4,2012,2015,3,3.8
Michael Kidd-Gilchrist ,1089,2,4,2012,2016,4,0.6
Michael Olowokandi ,1090,1,9,1998,1999,1,-0.3
Michael Olowokandi ,1090,1,9,1998,2000,2,-0.8
Michael Olowokandi ,1090,1,9,1998,2001,3,-0.4
Michael Olowokandi ,1090,1,9,1998,2002,4,1.6
Michael Olowokandi ,1090,1,9,1998,2003,5,-0.2
Michael Olowokandi ,1090,1,9,1998,2004,6,1.2
Michael Olowokandi ,1090,1,9,1998,2005,7,1.2
Michael Olowokandi ,1090,1,9,1998,2006,8,0.3
Michael Olowokandi ,1090,1,9,1998,2007,9,-0.1
Michael Redd ,1091,43,12,2000,2001,1,-0.1
Michael Redd ,1091,43,12,2000,2002,2,4.6
Michael Redd ,1091,43,12,2000,2003,3,8
Michael Redd ,1091,43,12,2000,2004,4,9.7
Michael Redd ,1091,43,12,2000,2005,5,6.2
Michael Redd ,1091,43,12,2000,2006,6,10.8
Michael Redd ,1091,43,12,2000,2007,7,6.1
Michael Redd ,1091,43,12,2000,2008,8,5.8
Michael Redd ,1091,43,12,2000,2009,9,3.2
Michael Redd ,1091,43,12,2000,2010,10,0.6
Michael Redd ,1091,43,12,2000,2011,11,0.1
Michael Redd ,1091,43,12,2000,2012,12,0.8
Michael Ruffin ,1092,32,9,1999,2000,1,0.6
Michael Ruffin ,1092,32,9,1999,2001,2,1
Michael Ruffin ,1092,32,9,1999,2002,3,0
Michael Ruffin ,1092,32,9,1999,2004,5,0.2
Michael Ruffin ,1092,32,9,1999,2005,6,1.9
Michael Ruffin ,1092,32,9,1999,2006,7,1.7
Michael Ruffin ,1092,32,9,1999,2007,8,0
Michael Ruffin ,1092,32,9,1999,2008,9,1.2
Michael Ruffin ,1092,32,9,1999,2009,10,0.1
Michael Smith ,1093,13,3,1989,1990,1,0.7
Michael Smith ,1093,13,3,1989,1991,2,0.3
Michael Smith ,1093,13,3,1989,1995,6,0.3
Michael Smith Y,1094,35,7,1994,1995,1,3.7
Michael Smith Y,1094,35,7,1994,1996,2,3.1
Michael Smith Y,1094,35,7,1994,1997,3,5.4
Michael Smith Y,1094,35,7,1994,1998,4,2.1
Michael Smith Y,1094,35,7,1994,1999,5,2.3
Michael Smith Y,1094,35,7,1994,2000,6,3.3
Michael Smith Y,1094,35,7,1994,2001,7,3.6
Michael Wiley ,1095,39,2,1980,1981,1,0.8
Michael Wiley ,1095,39,2,1980,1982,2,2.1
Michael Wilson ,1096,47,3,1982,1984,2,-0.1
Michael Wilson ,1096,47,3,1982,1985,3,0.4
Michael Wilson ,1096,47,3,1982,1987,5,-0.1
Michael Young ,1097,24,3,1984,1985,1,0
Michael Young ,1097,24,3,1984,1986,2,0
Michael Young ,1097,24,3,1984,1990,6,1.1
Micheal Ray Richardson ,1098,4,8,1978,1979,1,0.3
Micheal Ray Richardson ,1098,4,8,1978,1980,2,6
Micheal Ray Richardson ,1098,4,8,1978,1981,3,6.9
Micheal Ray Richardson ,1098,4,8,1978,1982,4,5.5
Micheal Ray Richardson ,1098,4,8,1978,1983,5,2
Micheal Ray Richardson ,1098,4,8,1978,1984,6,2.4
Micheal Ray Richardson ,1098,4,8,1978,1985,7,8.7
Micheal Ray Richardson ,1098,4,8,1978,1986,8,3.3
Micheal Williams ,1099,48,10,1988,1989,1,-0.2
Micheal Williams ,1099,48,10,1988,1990,2,0.7
Micheal Williams ,1099,48,10,1988,1991,3,5.7
Micheal Williams ,1099,48,10,1988,1992,4,9
Micheal Williams ,1099,48,10,1988,1993,5,7.6
Micheal Williams ,1099,48,10,1988,1994,6,5.6
Micheal Williams ,1099,48,10,1988,1995,7,0
Micheal Williams ,1099,48,10,1988,1996,8,-0.1
Micheal Williams ,1099,48,10,1988,1998,10,0.3
Micheal Williams ,1099,48,10,1988,1999,11,-0.1
Mickael Gelabale ,1100,48,3,2005,2007,2,1.3
Mickael Gelabale ,1100,48,3,2005,2008,3,0.2
Mickael Gelabale ,1100,48,3,2005,2013,8,1.5
Mickael Pietrus ,1101,11,10,2003,2004,1,1.5
Mickael Pietrus ,1101,11,10,2003,2005,2,2.1
Mickael Pietrus ,1101,11,10,2003,2006,3,0.6
Mickael Pietrus ,1101,11,10,2003,2007,4,3.6
Mickael Pietrus ,1101,11,10,2003,2008,5,2.8
Mickael Pietrus ,1101,11,10,2003,2009,6,3
Mickael Pietrus ,1101,11,10,2003,2010,7,3.6
Mickael Pietrus ,1101,11,10,2003,2011,8,1.3
Mickael Pietrus ,1101,11,10,2003,2012,9,1.2
Mickael Pietrus ,1101,11,10,2003,2013,10,0
Mike Bibby ,1102,2,14,1998,1999,1,1.3
Mike Bibby ,1102,2,14,1998,2000,2,5.6
Mike Bibby ,1102,2,14,1998,2001,3,5.3
Mike Bibby ,1102,2,14,1998,2002,4,6.3
Mike Bibby ,1102,2,14,1998,2003,5,5.6
Mike Bibby ,1102,2,14,1998,2004,6,9.3
Mike Bibby ,1102,2,14,1998,2005,7,8.5
Mike Bibby ,1102,2,14,1998,2006,8,8.4
Mike Bibby ,1102,2,14,1998,2007,9,4.4
Mike Bibby ,1102,2,14,1998,2008,10,2.1
Mike Bibby ,1102,2,14,1998,2009,11,6.9
Mike Bibby ,1102,2,14,1998,2010,12,4.8
Mike Bibby ,1102,2,14,1998,2011,13,4
Mike Bibby ,1102,2,14,1998,2012,14,0.7
Mike Brittain ,1103,29,2,1985,1986,1,0
Mike Brittain ,1103,29,2,1985,1987,2,0
Mike Conley ,1104,4,9,2007,2008,1,1.1
Mike Conley ,1104,4,9,2007,2009,2,4.5
Mike Conley ,1104,4,9,2007,2010,3,4
Mike Conley ,1104,4,9,2007,2011,4,6.6
Mike Conley ,1104,4,9,2007,2012,5,6.4
Mike Conley ,1104,4,9,2007,2013,6,9.9
Mike Conley ,1104,4,9,2007,2014,7,8.2
Mike Conley ,1104,4,9,2007,2015,8,6.8
Mike Conley ,1104,4,9,2007,2016,9,5.3
Mike Dunleavy ,1105,3,14,2002,2003,1,1.5
Mike Dunleavy ,1105,3,14,2002,2004,2,5.2
Mike Dunleavy ,1105,3,14,2002,2005,3,4.9
Mike Dunleavy ,1105,3,14,2002,2006,4,4.2
Mike Dunleavy ,1105,3,14,2002,2007,5,5.1
Mike Dunleavy ,1105,3,14,2002,2008,6,8.5
Mike Dunleavy ,1105,3,14,2002,2009,7,0.5
Mike Dunleavy ,1105,3,14,2002,2010,8,2.3
Mike Dunleavy ,1105,3,14,2002,2011,9,4.5
Mike Dunleavy ,1105,3,14,2002,2012,10,4.4
Mike Dunleavy ,1105,3,14,2002,2013,11,4.4
Mike Dunleavy ,1105,3,14,2002,2014,12,6.5
Mike Dunleavy ,1105,3,14,2002,2015,13,4.1
Mike Dunleavy ,1105,3,14,2002,2016,14,0.9
Mike Evans ,1106,21,9,1978,1980,2,0.1
Mike Evans ,1106,21,9,1978,1981,3,1.6
Mike Evans ,1106,21,9,1978,1982,4,-0.1
Mike Evans ,1106,21,9,1978,1983,5,-0.2
Mike Evans ,1106,21,9,1978,1984,6,0.9
Mike Evans ,1106,21,9,1978,1985,7,2.9
Mike Evans ,1106,21,9,1978,1986,8,1.1
Mike Evans ,1106,21,9,1978,1987,9,1.9
Mike Evans ,1106,21,9,1978,1988,10,1.1
Mike Gibson ,1107,44,2,1982,1984,2,0.1
Mike Gibson ,1107,44,2,1982,1986,4,0.2
Mike Gminski ,1108,7,14,1980,1981,1,1.5
Mike Gminski ,1108,7,14,1980,1982,2,1.8
Mike Gminski ,1108,7,14,1980,1983,3,4.3
Mike Gminski ,1108,7,14,1980,1984,4,4
Mike Gminski ,1108,7,14,1980,1985,5,6.1
Mike Gminski ,1108,7,14,1980,1986,6,9.2
Mike Gminski ,1108,7,14,1980,1987,7,5.4
Mike Gminski ,1108,7,14,1980,1988,8,6.5
Mike Gminski ,1108,7,14,1980,1989,9,7
Mike Gminski ,1108,7,14,1980,1990,10,6
Mike Gminski ,1108,7,14,1980,1991,11,2.9
Mike Gminski ,1108,7,14,1980,1992,12,0.5
Mike Gminski ,1108,7,14,1980,1993,13,0.5
Mike Gminski ,1108,7,14,1980,1994,14,0
Mike Iuzzolino ,1109,35,2,1991,1992,1,2.2
Mike Iuzzolino ,1109,35,2,1991,1993,2,1.5
Mike McGee ,1110,19,9,1981,1982,1,0.2
Mike McGee ,1110,19,9,1981,1983,2,0.2
Mike McGee ,1110,19,9,1981,1984,3,2.8
Mike McGee ,1110,19,9,1981,1985,4,3
Mike McGee ,1110,19,9,1981,1986,5,1.9
Mike McGee ,1110,19,9,1981,1987,6,3.2
Mike McGee ,1110,19,9,1981,1988,7,1.1
Mike McGee ,1110,19,9,1981,1989,8,2.3
Mike McGee ,1110,19,9,1981,1990,9,0.4
Mike Miller ,1111,5,16,2000,2001,1,5.3
Mike Miller ,1111,5,16,2000,2002,2,4.5
Mike Miller ,1111,5,16,2000,2003,3,4
Mike Miller ,1111,5,16,2000,2004,4,3.9
Mike Miller ,1111,5,16,2000,2005,5,7
Mike Miller ,1111,5,16,2000,2006,6,7.4
Mike Miller ,1111,5,16,2000,2007,7,4.8
Mike Miller ,1111,5,16,2000,2008,8,5
Mike Miller ,1111,5,16,2000,2009,9,4.2
Mike Miller ,1111,5,16,2000,2010,10,3.9
Mike Miller ,1111,5,16,2000,2011,11,1.6
Mike Miller ,1111,5,16,2000,2012,12,1.8
Mike Miller ,1111,5,16,2000,2013,13,2.6
Mike Miller ,1111,5,16,2000,2014,14,3.9
Mike Miller ,1111,5,16,2000,2015,15,0.4
Mike Miller ,1111,5,16,2000,2016,16,0.3
Mike Mitchell ,1112,15,10,1978,1979,1,3.6
Mike Mitchell ,1112,15,10,1978,1980,2,8.3
Mike Mitchell ,1112,15,10,1978,1981,3,6
Mike Mitchell ,1112,15,10,1978,1982,4,5.9
Mike Mitchell ,1112,15,10,1978,1983,5,7.6
Mike Mitchell ,1112,15,10,1978,1984,6,5.5
Mike Mitchell ,1112,15,10,1978,1985,7,6
Mike Mitchell ,1112,15,10,1978,1986,8,4.4
Mike Mitchell ,1112,15,10,1978,1987,9,0.4
Mike Mitchell ,1112,15,10,1978,1988,10,2.4
Mike Muscala ,1113,44,3,2013,2014,1,0.2
Mike Muscala ,1113,44,3,2013,2015,2,1.9
Mike Muscala ,1113,44,3,2013,2016,3,1.6
Mike O'Koren ,1114,6,8,1980,1981,1,3.8
Mike O'Koren ,1114,6,8,1980,1982,2,4.1
Mike O'Koren ,1114,6,8,1980,1983,3,2
Mike O'Koren ,1114,6,8,1980,1984,4,1.5
Mike O'Koren ,1114,6,8,1980,1985,5,1.9
Mike O'Koren ,1114,6,8,1980,1986,6,1.2
Mike O'Koren ,1114,6,8,1980,1987,7,-0.1
Mike O'Koren ,1114,6,8,1980,1988,8,0.1
Mike Scott ,1115,43,4,2012,2013,1,0.9
Mike Scott ,1115,43,4,2012,2014,2,2.6
Mike Scott ,1115,43,4,2012,2015,3,2.7
Mike Scott ,1115,43,4,2012,2016,4,3.2
Mike Smith ,1116,35,1,2000,2001,1,-0.1
Mike Smrek ,1117,25,7,1985,1986,1,-0.2
Mike Smrek ,1117,25,7,1985,1987,2,0.1
Mike Smrek ,1117,25,7,1985,1988,3,0.4
Mike Smrek ,1117,25,7,1985,1989,4,0.4
Mike Smrek ,1117,25,7,1985,1990,5,-0.1
Mike Smrek ,1117,25,7,1985,1991,6,0
Mike Smrek ,1117,25,7,1985,1992,7,0
Mike Sweetney ,1118,9,4,2003,2004,1,1.4
Mike Sweetney ,1118,9,4,2003,2005,2,3.8
Mike Sweetney ,1118,9,4,2003,2006,3,2.1
Mike Sweetney ,1118,9,4,2003,2007,4,0.4
Mike Woodson ,1119,12,11,1980,1981,1,0.9
Mike Woodson ,1119,12,11,1980,1982,2,5.7
Mike Woodson ,1119,12,11,1980,1983,3,7.8
Mike Woodson ,1119,12,11,1980,1984,4,4.2
Mike Woodson ,1119,12,11,1980,1985,5,4.2
Mike Woodson ,1119,12,11,1980,1986,6,4
Mike Woodson ,1119,12,11,1980,1987,7,0.9
Mike Woodson ,1119,12,11,1980,1988,8,3.1
Mike Woodson ,1119,12,11,1980,1989,9,3.5
Mike Woodson ,1119,12,11,1980,1990,10,0.7
Mike Woodson ,1119,12,11,1980,1991,11,-0.2
Mile Ilic ,1120,43,1,2005,2007,2,-0.2
Miles Plumlee ,1121,26,4,2012,2013,1,0
Miles Plumlee ,1121,26,4,2012,2014,2,4
Miles Plumlee ,1121,26,4,2012,2015,3,2.6
Miles Plumlee ,1121,26,4,2012,2016,4,2.2
Miles Simon ,1122,42,1,1998,1999,1,-0.1
Milos Babic ,1123,50,2,1990,1991,1,-0.1
Milos Babic ,1123,50,2,1990,1992,2,0
Milt Wagner ,1124,35,2,1986,1988,2,0.4
Milt Wagner ,1124,35,2,1986,1991,5,0
Mirsad Turkcan ,1125,18,1,1998,2000,2,0
Mitch McGary ,1126,21,2,2014,2015,1,1.3
Mitch McGary ,1126,21,2,2014,2016,2,0
Mitchell Wiggins ,1127,23,6,1983,1984,1,3.3
Mitchell Wiggins ,1127,23,6,1983,1985,2,3.5
Mitchell Wiggins ,1127,23,6,1983,1986,3,2
Mitchell Wiggins ,1127,23,6,1983,1987,4,1.2
Mitchell Wiggins ,1127,23,6,1983,1990,7,5.4
Mitchell Wiggins ,1127,23,6,1983,1992,9,-0.1
Mo Williams ,1128,47,13,2003,2004,1,0.2
Mo Williams ,1128,47,13,2003,2005,2,2.2
Mo Williams ,1128,47,13,2003,2006,3,2.5
Mo Williams ,1128,47,13,2003,2007,4,3.2
Mo Williams ,1128,47,13,2003,2008,5,4.5
Mo Williams ,1128,47,13,2003,2009,6,9.8
Mo Williams ,1128,47,13,2003,2010,7,6.7
Mo Williams ,1128,47,13,2003,2011,8,1
Mo Williams ,1128,47,13,2003,2012,9,2.8
Mo Williams ,1128,47,13,2003,2013,10,1.8
Mo Williams ,1128,47,13,2003,2014,11,2.2
Mo Williams ,1128,47,13,2003,2015,12,2.1
Mo Williams ,1128,47,13,2003,2016,13,1.1
Monta Ellis ,1129,40,11,2005,2006,1,0.5
Monta Ellis ,1129,40,11,2005,2007,2,4
Monta Ellis ,1129,40,11,2005,2008,3,9
Monta Ellis ,1129,40,11,2005,2009,4,0.2
Monta Ellis ,1129,40,11,2005,2010,5,1.3
Monta Ellis ,1129,40,11,2005,2011,6,6
Monta Ellis ,1129,40,11,2005,2012,7,2.6
Monta Ellis ,1129,40,11,2005,2013,8,4.6
Monta Ellis ,1129,40,11,2005,2014,9,4.9
Monta Ellis ,1129,40,11,2005,2015,10,3.6
Monta Ellis ,1129,40,11,2005,2016,11,4.3
Monti Davis ,1130,21,1,1980,1981,1,-0.1
Montrezl Harrell ,1131,32,1,2015,2016,1,0.9
Monty Williams ,1132,24,9,1994,1995,1,0.3
Monty Williams ,1132,24,9,1994,1996,2,-0.1
Monty Williams ,1132,24,9,1994,1997,3,1.2
Monty Williams ,1132,24,9,1994,1998,4,2.3
Monty Williams ,1132,24,9,1994,1999,5,0
Monty Williams ,1132,24,9,1994,2000,6,3.1
Monty Williams ,1132,24,9,1994,2001,7,1.3
Monty Williams ,1132,24,9,1994,2002,8,2.9
Monty Williams ,1132,24,9,1994,2003,9,0.5
Moochie Norris ,1133,33,9,1996,1997,1,-0.1
Moochie Norris ,1133,33,9,1996,1999,3,-0.2
Moochie Norris ,1133,33,9,1996,2000,4,1.7
Moochie Norris ,1133,33,9,1996,2001,5,4.4
Moochie Norris ,1133,33,9,1996,2002,6,1.8
Moochie Norris ,1133,33,9,1996,2003,7,1.7
Moochie Norris ,1133,33,9,1996,2004,8,0.8
Moochie Norris ,1133,33,9,1996,2005,9,-0.4
Moochie Norris ,1133,33,9,1996,2006,10,0.3
Mookie Blaylock ,1134,12,13,1989,1990,1,-0.3
Mookie Blaylock ,1134,12,13,1989,1991,2,2.1
Mookie Blaylock ,1134,12,13,1989,1992,3,4.9
Mookie Blaylock ,1134,12,13,1989,1993,4,7
Mookie Blaylock ,1134,12,13,1989,1994,5,10.2
Mookie Blaylock ,1134,12,13,1989,1995,6,9.4
Mookie Blaylock ,1134,12,13,1989,1996,7,9
Mookie Blaylock ,1134,12,13,1989,1997,8,12.5
Mookie Blaylock ,1134,12,13,1989,1998,9,5.6
Mookie Blaylock ,1134,12,13,1989,1999,10,4.7
Mookie Blaylock ,1134,12,13,1989,2000,11,3.3
Mookie Blaylock ,1134,12,13,1989,2001,12,3.5
Mookie Blaylock ,1134,12,13,1989,2002,13,-0.1
Morlon Wiley ,1135,46,7,1988,1989,1,0.2
Morlon Wiley ,1135,46,7,1988,1990,2,0.1
Morlon Wiley ,1135,46,7,1988,1991,3,0.1
Morlon Wiley ,1135,46,7,1988,1992,4,0.9
Morlon Wiley ,1135,46,7,1988,1993,5,0.5
Morlon Wiley ,1135,46,7,1988,1994,6,-0.2
Morlon Wiley ,1135,46,7,1988,1995,7,1.1
Morris Almond ,1136,25,3,2007,2008,1,-0.1
Morris Almond ,1136,25,3,2007,2009,2,0.1
Morris Almond ,1136,25,3,2007,2012,5,0
Morris Peterson ,1137,21,11,2000,2001,1,3.6
Morris Peterson ,1137,21,11,2000,2002,2,4.9
Morris Peterson ,1137,21,11,2000,2003,3,3.2
Morris Peterson ,1137,21,11,2000,2004,4,4.9
Morris Peterson ,1137,21,11,2000,2005,5,5.1
Morris Peterson ,1137,21,11,2000,2006,6,5.9
Morris Peterson ,1137,21,11,2000,2007,7,2.9
Morris Peterson ,1137,21,11,2000,2008,8,3.8
Morris Peterson ,1137,21,11,2000,2009,9,0.6
Morris Peterson ,1137,21,11,2000,2010,10,0.8
Morris Peterson ,1137,21,11,2000,2011,11,0
Mouhamed Sene ,1138,10,3,2006,2007,1,0
Mouhamed Sene ,1138,10,3,2006,2008,2,0.2
Mouhamed Sene ,1138,10,3,2006,2009,3,0.2
Muggsy Bogues ,1139,12,14,1987,1988,1,2.3
Muggsy Bogues ,1139,12,14,1987,1989,2,2.6
Muggsy Bogues ,1139,12,14,1987,1990,3,6.7
Muggsy Bogues ,1139,12,14,1987,1991,4,4.8
Muggsy Bogues ,1139,12,14,1987,1992,5,4.8
Muggsy Bogues ,1139,12,14,1987,1993,6,5.9
Muggsy Bogues ,1139,12,14,1987,1994,7,6.4
Muggsy Bogues ,1139,12,14,1987,1995,8,8.6
Muggsy Bogues ,1139,12,14,1987,1996,9,0
Muggsy Bogues ,1139,12,14,1987,1997,10,5
Muggsy Bogues ,1139,12,14,1987,1998,11,1.7
Muggsy Bogues ,1139,12,14,1987,1999,12,1.7
Muggsy Bogues ,1139,12,14,1987,2000,13,3.7
Muggsy Bogues ,1139,12,14,1987,2001,14,-0.1
Mychal Thompson ,1140,1,12,1978,1979,1,4.4
Mychal Thompson ,1140,1,12,1978,1981,3,5.3
Mychal Thompson ,1140,1,12,1978,1982,4,8.2
Mychal Thompson ,1140,1,12,1978,1983,5,5.4
Mychal Thompson ,1140,1,12,1978,1984,6,6.9
Mychal Thompson ,1140,1,12,1978,1985,7,6.1
Mychal Thompson ,1140,1,12,1978,1986,8,3.7
Mychal Thompson ,1140,1,12,1978,1987,9,2.6
Mychal Thompson ,1140,1,12,1978,1988,10,4.6
Mychal Thompson ,1140,1,12,1978,1989,11,5.2
Mychal Thompson ,1140,1,12,1978,1990,12,4.7
Mychal Thompson ,1140,1,12,1978,1991,13,2.1
Myles Turner ,1141,11,1,2015,2016,1,3.1
Myron Brown ,1142,34,1,1991,1992,1,0
Nate Blackwell ,1143,27,1,1987,1988,1,-0.1
Nate McMillan ,1144,30,12,1986,1987,1,4.1
Nate McMillan ,1144,30,12,1986,1988,2,6.5
Nate McMillan ,1144,30,12,1986,1989,3,4.4
Nate McMillan ,1144,30,12,1986,1990,4,4.9
Nate McMillan ,1144,30,12,1986,1991,5,2.8
Nate McMillan ,1144,30,12,1986,1992,6,3.7
Nate McMillan ,1144,30,12,1986,1993,7,5.6
Nate McMillan ,1144,30,12,1986,1994,8,6
Nate McMillan ,1144,30,12,1986,1995,9,5.1
Nate McMillan ,1144,30,12,1986,1996,10,3.7
Nate McMillan ,1144,30,12,1986,1997,11,2.6
Nate McMillan ,1144,30,12,1986,1998,12,0.8
Nate Robinson ,1145,21,11,2005,2006,1,1.5
Nate Robinson ,1145,21,11,2005,2007,2,3.2
Nate Robinson ,1145,21,11,2005,2008,3,3.2
Nate Robinson ,1145,21,11,2005,2009,4,5.9
Nate Robinson ,1145,21,11,2005,2010,5,2.2
Nate Robinson ,1145,21,11,2005,2011,6,1.1
Nate Robinson ,1145,21,11,2005,2012,7,2.8
Nate Robinson ,1145,21,11,2005,2013,8,5.9
Nate Robinson ,1145,21,11,2005,2014,9,1.8
Nate Robinson ,1145,21,11,2005,2015,10,0.3
Nate Robinson ,1145,21,11,2005,2016,11,0
Nate Wolters ,1146,38,2,2013,2014,1,1.2
Nate Wolters ,1146,38,2,2013,2015,2,-0.2
Nathan Jawai ,1147,41,2,2008,2009,1,-0.1
Nathan Jawai ,1147,41,2,2008,2010,2,0.3
Nazr Mohammed ,1148,29,18,1998,1999,1,0
Nazr Mohammed ,1148,29,18,1998,2000,2,-0.1
Nazr Mohammed ,1148,29,18,1998,2001,3,2.5
Nazr Mohammed ,1148,29,18,1998,2002,4,3.3
Nazr Mohammed ,1148,29,18,1998,2003,5,0.4
Nazr Mohammed ,1148,29,18,1998,2004,6,3.7
Nazr Mohammed ,1148,29,18,1998,2005,7,4.6
Nazr Mohammed ,1148,29,18,1998,2006,8,4.5
Nazr Mohammed ,1148,29,18,1998,2007,9,2.3
Nazr Mohammed ,1148,29,18,1998,2008,10,3.4
Nazr Mohammed ,1148,29,18,1998,2009,11,0
Nazr Mohammed ,1148,29,18,1998,2010,12,3.6
Nazr Mohammed ,1148,29,18,1998,2011,13,2.7
Nazr Mohammed ,1148,29,18,1998,2012,14,1.3
Nazr Mohammed ,1148,29,18,1998,2013,15,1.2
Nazr Mohammed ,1148,29,18,1998,2014,16,0.8
Nazr Mohammed ,1148,29,18,1998,2015,17,0.1
Nazr Mohammed ,1148,29,18,1998,2016,18,0
Ndudi Ebi ,1149,26,2,2003,2004,1,0
Ndudi Ebi ,1149,26,2,2003,2005,2,0.1
Negele Knight ,1150,31,6,1990,1991,1,0.6
Negele Knight ,1150,31,6,1990,1992,2,0.5
Negele Knight ,1150,31,6,1990,1993,3,0.1
Negele Knight ,1150,31,6,1990,1994,4,3.2
Negele Knight ,1150,31,6,1990,1995,5,-0.2
Negele Knight ,1150,31,6,1990,1999,9,-0.1
Nemanja Bjelica ,1151,35,1,2010,2016,6,1.9
Nemanja Nedovic ,1152,30,1,2013,2014,1,-0.4
Nenad Krstic ,1153,24,7,2002,2005,3,4.4
Nenad Krstic ,1153,24,7,2002,2006,4,5.4
Nenad Krstic ,1153,24,7,2002,2007,5,1.9
Nenad Krstic ,1153,24,7,2002,2008,6,-0.1
Nenad Krstic ,1153,24,7,2002,2009,7,1.7
Nenad Krstic ,1153,24,7,2002,2010,8,4.2
Nenad Krstic ,1153,24,7,2002,2011,9,4
Nene Hilario ,1154,7,14,2002,2003,1,5
Nene Hilario ,1154,7,14,2002,2004,2,6.1
Nene Hilario ,1154,7,14,2002,2005,3,3.2
Nene Hilario ,1154,7,14,2002,2006,4,-0.1
Nene Hilario ,1154,7,14,2002,2007,5,5.3
Nene Hilario ,1154,7,14,2002,2008,6,0.3
Nene Hilario ,1154,7,14,2002,2009,7,9.3
Nene Hilario ,1154,7,14,2002,2010,8,10.8
Nene Hilario ,1154,7,14,2002,2011,9,9.6
Nene Hilario ,1154,7,14,2002,2012,10,2.7
Nene Hilario ,1154,7,14,2002,2013,11,4
Nene Hilario ,1154,7,14,2002,2014,12,3.2
Nene Hilario ,1154,7,14,2002,2015,13,3
Nene Hilario ,1154,7,14,2002,2016,14,2.7
Nerlens Noel ,1155,6,2,2013,2015,2,4
Nerlens Noel ,1155,6,2,2013,2016,3,3
Nick Anderson ,1156,11,13,1989,1990,1,1.8
Nick Anderson ,1156,11,13,1989,1991,2,3.1
Nick Anderson ,1156,11,13,1989,1992,3,3.6
Nick Anderson ,1156,11,13,1989,1993,4,7.7
Nick Anderson ,1156,11,13,1989,1994,5,7.6
Nick Anderson ,1156,11,13,1989,1995,6,8.3
Nick Anderson ,1156,11,13,1989,1996,7,7.4
Nick Anderson ,1156,11,13,1989,1997,8,4.2
Nick Anderson ,1156,11,13,1989,1998,9,5.3
Nick Anderson ,1156,11,13,1989,1999,10,3.9
Nick Anderson ,1156,11,13,1989,2000,11,2.8
Nick Anderson ,1156,11,13,1989,2001,12,0
Nick Anderson ,1156,11,13,1989,2002,13,-0.4
Nick Calathes ,1157,45,2,2009,2014,5,1.5
Nick Calathes ,1157,45,2,2009,2015,6,1.1
Nick Collison ,1158,12,12,2003,2005,2,3.9
Nick Collison ,1158,12,12,2003,2006,3,2.3
Nick Collison ,1158,12,12,2003,2007,4,4.6
Nick Collison ,1158,12,12,2003,2008,5,4.5
Nick Collison ,1158,12,12,2003,2009,6,5
Nick Collison ,1158,12,12,2003,2010,7,4.7
Nick Collison ,1158,12,12,2003,2011,8,3.6
Nick Collison ,1158,12,12,2003,2012,9,3.5
Nick Collison ,1158,12,12,2003,2013,10,5.2
Nick Collison ,1158,12,12,2003,2014,11,3.6
Nick Collison ,1158,12,12,2003,2015,12,2.2
Nick Collison ,1158,12,12,2003,2016,13,0.8
Nick Fazekas ,1159,34,1,2007,2008,1,0.8
Nick Johnson ,1160,42,1,2014,2015,1,-0.1
Nick Van Exel ,1161,37,13,1993,1994,1,3.4
Nick Van Exel ,1161,37,13,1993,1995,2,6.4
Nick Van Exel ,1161,37,13,1993,1996,3,5.7
Nick Van Exel ,1161,37,13,1993,1997,4,7.2
Nick Van Exel ,1161,37,13,1993,1998,5,7.1
Nick Van Exel ,1161,37,13,1993,1999,6,2.2
Nick Van Exel ,1161,37,13,1993,2000,7,4.9
Nick Van Exel ,1161,37,13,1993,2001,8,6.4
Nick Van Exel ,1161,37,13,1993,2002,9,4.4
Nick Van Exel ,1161,37,13,1993,2003,10,4
Nick Van Exel ,1161,37,13,1993,2004,11,1.2
Nick Van Exel ,1161,37,13,1993,2005,12,1.6
Nick Van Exel ,1161,37,13,1993,2006,13,1.4
Nick Vanos ,1162,32,2,1985,1986,1,-0.4
Nick Vanos ,1162,32,2,1985,1987,2,0.3
Nick Young ,1163,16,9,2007,2008,1,0.4
Nick Young ,1163,16,9,2007,2009,2,1.2
Nick Young ,1163,16,9,2007,2010,3,1.4
Nick Young ,1163,16,9,2007,2011,4,2.8
Nick Young ,1163,16,9,2007,2012,5,1.9
Nick Young ,1163,16,9,2007,2013,6,2.3
Nick Young ,1163,16,9,2007,2014,7,2.5
Nick Young ,1163,16,9,2007,2015,8,1.2
Nick Young ,1163,16,9,2007,2016,9,0.1
Nicolas Batum ,1164,25,8,2008,2009,1,3.7
Nicolas Batum ,1164,25,8,2008,2010,2,3.5
Nicolas Batum ,1164,25,8,2008,2011,3,6.6
Nicolas Batum ,1164,25,8,2008,2012,4,4.8
Nicolas Batum ,1164,25,8,2008,2013,5,5.8
Nicolas Batum ,1164,25,8,2008,2014,6,7.9
Nicolas Batum ,1164,25,8,2008,2015,7,5.2
Nicolas Batum ,1164,25,8,2008,2016,8,5
Nik Stauskas ,1165,8,2,2014,2015,1,0.5
Nik Stauskas ,1165,8,2,2014,2016,2,0.5
Nikita Wilson ,1166,30,1,1987,1988,1,-0.1
Nikola Jokic ,1167,41,1,2014,2016,2,6.7
Nikola Mirotic ,1168,23,2,2011,2015,4,5.7
Nikola Mirotic ,1168,23,2,2011,2016,5,3.9
Nikola Pekovic ,1169,31,6,2008,2011,3,0.6
Nikola Pekovic ,1169,31,6,2008,2012,4,4.5
Nikola Pekovic ,1169,31,6,2008,2013,5,6.7
Nikola Pekovic ,1169,31,6,2008,2014,6,5.9
Nikola Pekovic ,1169,31,6,2008,2015,7,1.2
Nikola Pekovic ,1169,31,6,2008,2016,8,-0.1
Nikola Vucevic ,1170,16,5,2011,2012,1,1.8
Nikola Vucevic ,1170,16,5,2011,2013,2,5.7
Nikola Vucevic ,1170,16,5,2011,2014,3,4.4
Nikola Vucevic ,1170,16,5,2011,2015,4,7
Nikola Vucevic ,1170,16,5,2011,2016,5,5.2
Nikoloz Tskitishvili ,1171,5,4,2002,2003,1,-1
Nikoloz Tskitishvili ,1171,5,4,2002,2004,2,-0.1
Nikoloz Tskitishvili ,1171,5,4,2002,2005,3,-0.5
Nikoloz Tskitishvili ,1171,5,4,2002,2006,4,0
Noah Vonleh ,1172,9,2,2014,2015,1,0.5
Noah Vonleh ,1172,9,2,2014,2016,2,1.2
Nolan Smith ,1173,21,2,2011,2012,1,-0.3
Nolan Smith ,1173,21,2,2011,2013,2,-0.5
Norman Powell ,1174,46,1,2015,2016,1,1.6
Norris Cole ,1175,28,5,2011,2012,1,0
Norris Cole ,1175,28,5,2011,2013,2,0.6
Norris Cole ,1175,28,5,2011,2014,3,1.2
Norris Cole ,1175,28,5,2011,2015,4,1.4
Norris Cole ,1175,28,5,2011,2016,5,-0.1
Norris Coleman ,1176,38,1,1987,1988,1,-0.4
O.J. Mayo ,1177,3,8,2008,2009,1,3.4
O.J. Mayo ,1177,3,8,2008,2010,2,5.6
O.J. Mayo ,1177,3,8,2008,2011,3,2.4
O.J. Mayo ,1177,3,8,2008,2012,4,3.5
O.J. Mayo ,1177,3,8,2008,2013,5,4.2
O.J. Mayo ,1177,3,8,2008,2014,6,0.1
O.J. Mayo ,1177,3,8,2008,2015,7,2.8
O.J. Mayo ,1177,3,8,2008,2016,8,-0.1
Obinna Ekezie ,1178,37,4,1999,2000,1,0.5
Obinna Ekezie ,1178,37,4,1999,2001,2,0.4
Obinna Ekezie ,1178,37,4,1999,2002,3,0.2
Obinna Ekezie ,1178,37,4,1999,2005,6,0.7
Olden Polynice ,1179,8,15,1987,1988,1,1.6
Olden Polynice ,1179,8,15,1987,1989,2,1.5
Olden Polynice ,1179,8,15,1987,1990,3,2.5
Olden Polynice ,1179,8,15,1987,1991,4,5.2
Olden Polynice ,1179,8,15,1987,1992,5,4.5
Olden Polynice ,1179,8,15,1987,1993,6,2.6
Olden Polynice ,1179,8,15,1987,1994,7,5.1
Olden Polynice ,1179,8,15,1987,1995,8,6.7
Olden Polynice ,1179,8,15,1987,1996,9,5.3
Olden Polynice ,1179,8,15,1987,1997,10,3.3
Olden Polynice ,1179,8,15,1987,1998,11,1.5
Olden Polynice ,1179,8,15,1987,1999,12,2
Olden Polynice ,1179,8,15,1987,2000,13,3.2
Olden Polynice ,1179,8,15,1987,2001,14,2
Olden Polynice ,1179,8,15,1987,2004,17,-0.1
Oleksiy Pecherov ,1180,18,3,2006,2008,2,0
Oleksiy Pecherov ,1180,18,3,2006,2009,3,0.5
Oleksiy Pecherov ,1180,18,3,2006,2010,4,0.1
Oliver Miller ,1181,22,9,1992,1993,1,1.6
Oliver Miller ,1181,22,9,1992,1994,2,5.3
Oliver Miller ,1181,22,9,1992,1995,3,3.1
Oliver Miller ,1181,22,9,1992,1996,4,3.8
Oliver Miller ,1181,22,9,1992,1997,5,1.8
Oliver Miller ,1181,22,9,1992,1998,6,0.9
Oliver Miller ,1181,22,9,1992,1999,7,0
Oliver Miller ,1181,22,9,1992,2000,8,3.4
Oliver Miller ,1181,22,9,1992,2004,12,1.4
Oliver Robinson ,1182,24,1,1982,1983,1,0.1
Ollie Mack ,1183,25,3,1979,1980,1,1
Ollie Mack ,1183,25,3,1979,1981,2,1.6
Ollie Mack ,1183,25,3,1979,1982,3,-0.1
Olumide Oyedeji ,1184,42,3,2000,2001,1,0.4
Olumide Oyedeji ,1184,42,3,2000,2002,2,0.4
Olumide Oyedeji ,1184,42,3,2000,2003,3,0.3
Omar Cook ,1185,31,2,2001,2004,3,-0.2
Omar Cook ,1185,31,2,2001,2005,4,0.1
Omer Asik ,1186,36,6,2008,2011,3,2.7
Omer Asik ,1186,36,6,2008,2012,4,2.6
Omer Asik ,1186,36,6,2008,2013,5,5.5
Omer Asik ,1186,36,6,2008,2014,6,2.4
Omer Asik ,1186,36,6,2008,2015,7,5
Omer Asik ,1186,36,6,2008,2016,8,1.7
Omri Casspi ,1187,23,7,2009,2010,1,2.5
Omri Casspi ,1187,23,7,2009,2011,2,2.5
Omri Casspi ,1187,23,7,2009,2012,3,1.2
Omri Casspi ,1187,23,7,2009,2013,4,0.7
Omri Casspi ,1187,23,7,2009,2014,5,2.4
Omri Casspi ,1187,23,7,2009,2015,6,2.7
Omri Casspi ,1187,23,7,2009,2016,7,3.6
Orlando Graham ,1188,40,1,1988,1989,1,0
Orlando Johnson ,1189,36,3,2012,2013,1,1.5
Orlando Johnson ,1189,36,3,2012,2014,2,0.1
Orlando Johnson ,1189,36,3,2012,2016,4,-0.2
Orlando Woolridge ,1190,6,13,1981,1982,1,1.8
Orlando Woolridge ,1190,6,13,1981,1983,2,3.6
Orlando Woolridge ,1190,6,13,1981,1984,3,5.3
Orlando Woolridge ,1190,6,13,1981,1985,4,9
Orlando Woolridge ,1190,6,13,1981,1986,5,5.6
Orlando Woolridge ,1190,6,13,1981,1987,6,6.8
Orlando Woolridge ,1190,6,13,1981,1988,7,0.8
Orlando Woolridge ,1190,6,13,1981,1989,8,3.3
Orlando Woolridge ,1190,6,13,1981,1990,9,4.8
Orlando Woolridge ,1190,6,13,1981,1991,10,3.9
Orlando Woolridge ,1190,6,13,1981,1992,11,4.4
Orlando Woolridge ,1190,6,13,1981,1993,12,2.3
Orlando Woolridge ,1190,6,13,1981,1994,13,1.5
Othell Wilson ,1191,35,2,1984,1985,1,0.7
Othell Wilson ,1191,35,2,1984,1987,3,0.6
Othella Harrington ,1192,30,12,1996,1997,1,1.4
Othella Harrington ,1192,30,12,1996,1998,2,1.7
Othella Harrington ,1192,30,12,1996,1999,3,2.2
Othella Harrington ,1192,30,12,1996,2000,4,3
Othella Harrington ,1192,30,12,1996,2001,5,2.5
Othella Harrington ,1192,30,12,1996,2002,6,3
Othella Harrington ,1192,30,12,1996,2003,7,3.8
Othella Harrington ,1192,30,12,1996,2004,8,0.8
Othella Harrington ,1192,30,12,1996,2005,9,3.6
Othella Harrington ,1192,30,12,1996,2006,10,1.1
Othella Harrington ,1192,30,12,1996,2007,11,0
Othella Harrington ,1192,30,12,1996,2008,12,0
Otis Smith ,1193,41,6,1986,1987,1,-0.2
Otis Smith ,1193,41,6,1986,1988,2,3.6
Otis Smith ,1193,41,6,1986,1989,3,2.5
Otis Smith ,1193,41,6,1986,1990,4,3.3
Otis Smith ,1193,41,6,1986,1991,5,3.5
Otis Smith ,1193,41,6,1986,1992,6,-0.4
Otis Thorpe ,1194,9,17,1984,1985,1,4
Otis Thorpe ,1194,9,17,1984,1986,2,3.8
Otis Thorpe ,1194,9,17,1984,1987,3,9
Otis Thorpe ,1194,9,17,1984,1988,4,8.1
Otis Thorpe ,1194,9,17,1984,1989,5,8.7
Otis Thorpe ,1194,9,17,1984,1990,6,8.5
Otis Thorpe ,1194,9,17,1984,1991,7,10.4
Otis Thorpe ,1194,9,17,1984,1992,8,8.9
Otis Thorpe ,1194,9,17,1984,1993,9,6
Otis Thorpe ,1194,9,17,1984,1994,10,9.8
Otis Thorpe ,1194,9,17,1984,1995,11,5.6
Otis Thorpe ,1194,9,17,1984,1996,12,7.6
Otis Thorpe ,1194,9,17,1984,1997,13,7.9
Otis Thorpe ,1194,9,17,1984,1998,14,2.5
Otis Thorpe ,1194,9,17,1984,1999,15,3.7
Otis Thorpe ,1194,9,17,1984,2000,16,1.1
Otis Thorpe ,1194,9,17,1984,2001,17,1
Otto Porter ,1195,3,3,2013,2014,1,0
Otto Porter ,1195,3,3,2013,2015,2,2.7
Otto Porter ,1195,3,3,2013,2016,3,5.6
P.J. Brown ,1196,29,15,1992,1994,2,4.2
P.J. Brown ,1196,29,15,1992,1995,3,4.6
P.J. Brown ,1196,29,15,1992,1996,4,5.3
P.J. Brown ,1196,29,15,1992,1997,5,7.5
P.J. Brown ,1196,29,15,1992,1998,6,7.5
P.J. Brown ,1196,29,15,1992,1999,7,5.1
P.J. Brown ,1196,29,15,1992,2000,8,6.9
P.J. Brown ,1196,29,15,1992,2001,9,8
P.J. Brown ,1196,29,15,1992,2002,10,8.2
P.J. Brown ,1196,29,15,1992,2003,11,10.2
P.J. Brown ,1196,29,15,1992,2004,12,8.1
P.J. Brown ,1196,29,15,1992,2005,13,6.9
P.J. Brown ,1196,29,15,1992,2006,14,4.4
P.J. Brown ,1196,29,15,1992,2007,15,2.3
P.J. Brown ,1196,29,15,1992,2008,16,0.5
P.J. Hairston ,1197,26,2,2014,2015,1,0.3
P.J. Hairston ,1197,26,2,2014,2016,2,0.6
P.J. Tucker ,1198,35,5,2006,2007,1,0.1
P.J. Tucker ,1198,35,5,2006,2013,7,2.9
P.J. Tucker ,1198,35,5,2006,2014,8,6.1
P.J. Tucker ,1198,35,5,2006,2015,9,4.9
P.J. Tucker ,1198,35,5,2006,2016,10,3.5
Pace Mannion ,1199,43,6,1983,1984,1,0.4
Pace Mannion ,1199,43,6,1983,1985,2,0.2
Pace Mannion ,1199,43,6,1983,1986,3,0.9
Pace Mannion ,1199,43,6,1983,1987,4,-0.2
Pace Mannion ,1199,43,6,1983,1988,5,0.3
Pace Mannion ,1199,43,6,1983,1989,6,0
Pape Sow ,1200,47,3,2004,2005,1,0.2
Pape Sow ,1200,47,3,2004,2006,2,0.6
Pape Sow ,1200,47,3,2004,2007,3,0.1
Pat Connaughton ,1201,41,1,2015,2016,1,-0.2
Pat Durham ,1202,35,2,1989,1993,4,-0.2
Pat Durham ,1202,35,2,1989,1995,6,0.9
Pat Garrity ,1203,19,10,1998,1999,1,1.1
Pat Garrity ,1203,19,10,1998,2000,2,2.8
Pat Garrity ,1203,19,10,1998,2001,3,2.5
Pat Garrity ,1203,19,10,1998,2002,4,5.1
Pat Garrity ,1203,19,10,1998,2003,5,4.9
Pat Garrity ,1203,19,10,1998,2004,6,0
Pat Garrity ,1203,19,10,1998,2005,7,1.1
Pat Garrity ,1203,19,10,1998,2006,8,1.2
Pat Garrity ,1203,19,10,1998,2007,9,0.2
Pat Garrity ,1203,19,10,1998,2008,10,-0.2
Patrick Beverley ,1204,42,4,2009,2013,4,2.2
Patrick Beverley ,1204,42,4,2009,2014,5,4.2
Patrick Beverley ,1204,42,4,2009,2015,6,3.5
Patrick Beverley ,1204,42,4,2009,2016,7,4.4
Patrick Ewing ,1205,43,1,2008,2011,3,-0.1
Patrick Ewing ,1205,1,17,1985,2011,26,-0.1
Patrick O'Bryant ,1206,9,4,2006,2007,1,0
Patrick O'Bryant ,1206,9,4,2006,2008,2,0.2
Patrick O'Bryant ,1206,9,4,2006,2009,3,0.3
Patrick O'Bryant ,1206,9,4,2006,2010,4,0
Patrick Patterson ,1207,14,6,2010,2011,1,2.4
Patrick Patterson ,1207,14,6,2010,2012,2,1.6
Patrick Patterson ,1207,14,6,2010,2013,3,4.1
Patrick Patterson ,1207,14,6,2010,2014,4,3.8
Patrick Patterson ,1207,14,6,2010,2015,5,6.1
Patrick Patterson ,1207,14,6,2010,2016,6,3.6
Pau Gasol ,1208,3,15,2001,2002,1,7.6
Pau Gasol ,1208,3,15,2001,2003,2,8.5
Pau Gasol ,1208,3,15,2001,2004,3,8.1
Pau Gasol ,1208,3,15,2001,2005,4,6.8
Pau Gasol ,1208,3,15,2001,2006,5,12
Pau Gasol ,1208,3,15,2001,2007,6,6.9
Pau Gasol ,1208,3,15,2001,2008,7,8.4
Pau Gasol ,1208,3,15,2001,2009,8,13.9
Pau Gasol ,1208,3,15,2001,2010,9,11
Pau Gasol ,1208,3,15,2001,2011,10,14.7
Pau Gasol ,1208,3,15,2001,2012,11,8.3
Pau Gasol ,1208,3,15,2001,2013,12,3.7
Pau Gasol ,1208,3,15,2001,2014,13,3
Pau Gasol ,1208,3,15,2001,2015,14,10.4
Pau Gasol ,1208,3,15,2001,2016,15,7.1
Paul Davis ,1209,34,4,2006,2007,1,0.2
Paul Davis ,1209,34,4,2006,2008,2,0
Paul Davis ,1209,34,4,2006,2009,3,0.2
Paul Davis ,1209,34,4,2006,2010,4,0
Paul George ,1210,10,6,2010,2011,1,2.4
Paul George ,1210,10,6,2010,2012,2,6
Paul George ,1210,10,6,2010,2013,3,9
Paul George ,1210,10,6,2010,2014,4,10.8
Paul George ,1210,10,6,2010,2015,5,0
Paul George ,1210,10,6,2010,2016,6,9.2
Paul Grant ,1211,20,2,1997,1999,2,-0.1
Paul Grant ,1211,20,2,1997,2004,7,0
Paul Millsap ,1212,47,10,2006,2007,1,4.7
Paul Millsap ,1212,47,10,2006,2008,2,5.2
Paul Millsap ,1212,47,10,2006,2009,3,7.7
Paul Millsap ,1212,47,10,2006,2010,4,7.2
Paul Millsap ,1212,47,10,2006,2011,5,7.7
Paul Millsap ,1212,47,10,2006,2012,6,7.8
Paul Millsap ,1212,47,10,2006,2013,7,7.6
Paul Millsap ,1212,47,10,2006,2014,8,6.7
Paul Millsap ,1212,47,10,2006,2015,9,8.3
Paul Millsap ,1212,47,10,2006,2016,10,10.1
Paul Mokeski ,1213,42,12,1979,1980,1,-0.1
Paul Mokeski ,1213,42,12,1979,1981,2,1.7
Paul Mokeski ,1213,42,12,1979,1982,3,0.8
Paul Mokeski ,1213,42,12,1979,1983,4,1.4
Paul Mokeski ,1213,42,12,1979,1984,5,1.6
Paul Mokeski ,1213,42,12,1979,1985,6,3.4
Paul Mokeski ,1213,42,12,1979,1986,7,0.9
Paul Mokeski ,1213,42,12,1979,1987,8,1.1
Paul Mokeski ,1213,42,12,1979,1988,9,1.3
Paul Mokeski ,1213,42,12,1979,1989,10,1
Paul Mokeski ,1213,42,12,1979,1990,11,0.2
Paul Mokeski ,1213,42,12,1979,1991,12,0.3
Paul Pierce ,1214,10,18,1998,1999,1,4.9
Paul Pierce ,1214,10,18,1998,2000,2,8.2
Paul Pierce ,1214,10,18,1998,2001,3,10.4
Paul Pierce ,1214,10,18,1998,2002,4,12.9
Paul Pierce ,1214,10,18,1998,2003,5,10.1
Paul Pierce ,1214,10,18,1998,2004,6,7.1
Paul Pierce ,1214,10,18,1998,2005,7,11.2
Paul Pierce ,1214,10,18,1998,2006,8,11.5
Paul Pierce ,1214,10,18,1998,2007,9,5.4
Paul Pierce ,1214,10,18,1998,2008,10,12.4
Paul Pierce ,1214,10,18,1998,2009,11,10.3
Paul Pierce ,1214,10,18,1998,2010,12,8.3
Paul Pierce ,1214,10,18,1998,2011,13,11.6
Paul Pierce ,1214,10,18,1998,2012,14,7
Paul Pierce ,1214,10,18,1998,2013,15,7.2
Paul Pierce ,1214,10,18,1998,2014,16,5.2
Paul Pierce ,1214,10,18,1998,2015,17,5.5
Paul Pierce ,1214,10,18,1998,2016,18,0.9
Paul Pressey ,1215,20,11,1982,1983,1,2
Paul Pressey ,1215,20,11,1982,1984,2,3.8
Paul Pressey ,1215,20,11,1982,1985,3,9.6
Paul Pressey ,1215,20,11,1982,1986,4,9.8
Paul Pressey ,1215,20,11,1982,1987,5,5.5
Paul Pressey ,1215,20,11,1982,1988,6,7.1
Paul Pressey ,1215,20,11,1982,1989,7,4.8
Paul Pressey ,1215,20,11,1982,1990,8,3
Paul Pressey ,1215,20,11,1982,1991,9,3.2
Paul Pressey ,1215,20,11,1982,1992,10,0.3
Paul Pressey ,1215,20,11,1982,1993,11,0.1
Paul Thompson ,1216,50,3,1983,1984,1,3.7
Paul Thompson ,1216,50,3,1983,1985,2,1.1
Paul Thompson ,1216,50,3,1983,1986,3,0.1
Pavel Podkolzin ,1217,21,2,2004,2005,1,0
Pavel Podkolzin ,1217,21,2,2004,2006,2,-0.1
Pearl Washington ,1218,13,3,1986,1987,1,0.7
Pearl Washington ,1218,13,3,1986,1988,2,0.7
Pearl Washington ,1218,13,3,1986,1989,3,0.5
Peja Stojakovic ,1219,14,13,1996,1999,3,1.7
Peja Stojakovic ,1219,14,13,1996,2000,4,4.8
Peja Stojakovic ,1219,14,13,1996,2001,5,10.1
Peja Stojakovic ,1219,14,13,1996,2002,6,9.9
Peja Stojakovic ,1219,14,13,1996,2003,7,10.1
Peja Stojakovic ,1219,14,13,1996,2004,8,13.5
Peja Stojakovic ,1219,14,13,1996,2005,9,7.3
Peja Stojakovic ,1219,14,13,1996,2006,10,8
Peja Stojakovic ,1219,14,13,1996,2007,11,0.9
Peja Stojakovic ,1219,14,13,1996,2008,12,8.1
Peja Stojakovic ,1219,14,13,1996,2009,13,3.8
Peja Stojakovic ,1219,14,13,1996,2010,14,2.7
Peja Stojakovic ,1219,14,13,1996,2011,15,1.6
Perry Jones ,1220,28,3,2012,2013,1,0
Perry Jones ,1220,28,3,2012,2014,2,1.5
Perry Jones ,1220,28,3,2012,2015,3,0.2
Pervis Ellison ,1221,1,11,1989,1990,1,0.4
Pervis Ellison ,1221,1,11,1989,1991,2,4
Pervis Ellison ,1221,1,11,1989,1992,3,6.9
Pervis Ellison ,1221,1,11,1989,1993,4,3.9
Pervis Ellison ,1221,1,11,1989,1994,5,0.7
Pervis Ellison ,1221,1,11,1989,1995,6,1.8
Pervis Ellison ,1221,1,11,1989,1996,7,2.6
Pervis Ellison ,1221,1,11,1989,1997,8,0
Pervis Ellison ,1221,1,11,1989,1998,9,1.1
Pervis Ellison ,1221,1,11,1989,2000,11,0.5
Pervis Ellison ,1221,1,11,1989,2001,12,0
Pete Chilcutt ,1222,27,9,1991,1992,1,0.7
Pete Chilcutt ,1222,27,9,1991,1993,2,1
Pete Chilcutt ,1222,27,9,1991,1994,3,1.5
Pete Chilcutt ,1222,27,9,1991,1995,4,2.1
Pete Chilcutt ,1222,27,9,1991,1996,5,1.4
Pete Chilcutt ,1222,27,9,1991,1997,6,1.1
Pete Chilcutt ,1222,27,9,1991,1998,7,2
Pete Chilcutt ,1222,27,9,1991,1999,8,0.3
Pete Chilcutt ,1222,27,9,1991,2000,9,0.6
Peter John Ramos ,1223,32,1,2004,2005,1,0
Phil Ford ,1224,2,7,1978,1979,1,5.7
Phil Ford ,1224,2,7,1978,1980,2,6.1
Phil Ford ,1224,2,7,1978,1981,3,5.2
Phil Ford ,1224,2,7,1978,1982,4,0.9
Phil Ford ,1224,2,7,1978,1983,5,2.4
Phil Ford ,1224,2,7,1978,1984,6,2.9
Phil Ford ,1224,2,7,1978,1985,7,0.2
Phil Hubbard ,1225,15,10,1979,1980,1,1.6
Phil Hubbard ,1225,15,10,1979,1981,2,4.5
Phil Hubbard ,1225,15,10,1979,1982,3,2.6
Phil Hubbard ,1225,15,10,1979,1983,4,3.4
Phil Hubbard ,1225,15,10,1979,1984,5,4.6
Phil Hubbard ,1225,15,10,1979,1985,6,5.7
Phil Hubbard ,1225,15,10,1979,1986,7,0.2
Phil Hubbard ,1225,15,10,1979,1987,8,3.3
Phil Hubbard ,1225,15,10,1979,1988,9,2.7
Phil Hubbard ,1225,15,10,1979,1989,10,0.4
Phil Zevenbergen ,1226,50,1,1987,1988,1,0
Pooh Richardson ,1227,10,10,1989,1990,1,4.4
Pooh Richardson ,1227,10,10,1989,1991,2,5.9
Pooh Richardson ,1227,10,10,1989,1992,3,4.1
Pooh Richardson ,1227,10,10,1989,1993,4,4
Pooh Richardson ,1227,10,10,1989,1994,5,1.4
Pooh Richardson ,1227,10,10,1989,1995,6,2.1
Pooh Richardson ,1227,10,10,1989,1996,7,3.8
Pooh Richardson ,1227,10,10,1989,1997,8,1
Pooh Richardson ,1227,10,10,1989,1998,9,0.2
Pooh Richardson ,1227,10,10,1989,1999,10,-0.1
Popeye Jones ,1228,41,11,1992,1994,2,3.6
Popeye Jones ,1228,41,11,1992,1995,3,3.6
Popeye Jones ,1228,41,11,1992,1996,4,3.7
Popeye Jones ,1228,41,11,1992,1997,5,4.2
Popeye Jones ,1228,41,11,1992,1998,6,0.3
Popeye Jones ,1228,41,11,1992,1999,7,0.5
Popeye Jones ,1228,41,11,1992,2000,8,0.6
Popeye Jones ,1228,41,11,1992,2001,9,1.2
Popeye Jones ,1228,41,11,1992,2002,10,4.3
Popeye Jones ,1228,41,11,1992,2003,11,0
Popeye Jones ,1228,41,11,1992,2004,12,0
Predrag Drobnjak ,1229,48,4,1997,2002,5,1.6
Predrag Drobnjak ,1229,48,4,1997,2003,6,2.4
Predrag Drobnjak ,1229,48,4,1997,2004,7,0.7
Predrag Drobnjak ,1229,48,4,1997,2005,8,1
Priest Lauderdale ,1230,28,2,1996,1997,1,-0.2
Priest Lauderdale ,1230,28,2,1996,1998,2,-0.6
Primoz Brezec ,1231,27,8,2000,2002,2,0.3
Primoz Brezec ,1231,27,8,2000,2003,3,0.1
Primoz Brezec ,1231,27,8,2000,2004,4,0.1
Primoz Brezec ,1231,27,8,2000,2005,5,4.9
Primoz Brezec ,1231,27,8,2000,2006,6,4.6
Primoz Brezec ,1231,27,8,2000,2007,7,0.7
Primoz Brezec ,1231,27,8,2000,2008,8,0.2
Primoz Brezec ,1231,27,8,2000,2010,10,0
Purvis Short ,1232,5,12,1978,1979,1,2.6
Purvis Short ,1232,5,12,1978,1980,2,3.7
Purvis Short ,1232,5,12,1978,1981,3,5.4
Purvis Short ,1232,5,12,1978,1982,4,5
Purvis Short ,1232,5,12,1978,1983,5,5.2
Purvis Short ,1232,5,12,1978,1984,6,6
Purvis Short ,1232,5,12,1978,1985,7,6.2
Purvis Short ,1232,5,12,1978,1986,8,5.7
Purvis Short ,1232,5,12,1978,1987,9,2.2
Purvis Short ,1232,5,12,1978,1988,10,4.4
Purvis Short ,1232,5,12,1978,1989,11,1.4
Purvis Short ,1232,5,12,1978,1990,12,3.3
Quentin Richardson ,1233,18,13,2000,2001,1,3
Quentin Richardson ,1233,18,13,2000,2002,2,5.6
Quentin Richardson ,1233,18,13,2000,2003,3,1
Quentin Richardson ,1233,18,13,2000,2004,4,2.4
Quentin Richardson ,1233,18,13,2000,2005,5,5.8
Quentin Richardson ,1233,18,13,2000,2006,6,0.7
Quentin Richardson ,1233,18,13,2000,2007,7,3.5
Quentin Richardson ,1233,18,13,2000,2008,8,0.3
Quentin Richardson ,1233,18,13,2000,2009,9,2.1
Quentin Richardson ,1233,18,13,2000,2010,10,5.8
Quentin Richardson ,1233,18,13,2000,2011,11,1.3
Quentin Richardson ,1233,18,13,2000,2012,12,1.3
Quentin Richardson ,1233,18,13,2000,2013,13,-0.1
Quincy Acy ,1234,37,4,2012,2013,1,1.1
Quincy Acy ,1234,37,4,2012,2014,2,1.5
Quincy Acy ,1234,37,4,2012,2015,3,1.7
Quincy Acy ,1234,37,4,2012,2016,4,2.5
Quincy Douby ,1235,19,3,2006,2007,1,0
Quincy Douby ,1235,19,3,2006,2008,2,0
Quincy Douby ,1235,19,3,2006,2009,3,0
Quincy Lewis ,1236,19,4,1999,2000,1,0.3
Quincy Lewis ,1236,19,4,1999,2001,2,0.3
Quincy Lewis ,1236,19,4,1999,2002,3,0.1
Quincy Lewis ,1236,19,4,1999,2004,5,0
Quincy Miller ,1237,38,3,2012,2013,1,0
Quincy Miller ,1237,38,3,2012,2014,2,0
Quincy Miller ,1237,38,3,2012,2015,3,-0.1
Quincy Pondexter ,1238,26,5,2010,2011,1,0.9
Quincy Pondexter ,1238,26,5,2010,2012,2,1.7
Quincy Pondexter ,1238,26,5,2010,2013,3,3.2
Quincy Pondexter ,1238,26,5,2010,2014,4,0.4
Quincy Pondexter ,1238,26,5,2010,2015,5,2.9
Quintin Dailey ,1239,7,10,1982,1983,1,2.1
Quintin Dailey ,1239,7,10,1982,1984,2,3.7
Quintin Dailey ,1239,7,10,1982,1985,3,2.6
Quintin Dailey ,1239,7,10,1982,1986,4,1
Quintin Dailey ,1239,7,10,1982,1987,5,-0.3
Quintin Dailey ,1239,7,10,1982,1988,6,1.3
Quintin Dailey ,1239,7,10,1982,1989,7,2
Quintin Dailey ,1239,7,10,1982,1990,8,0.1
Quintin Dailey ,1239,7,10,1982,1991,9,0.3
Quintin Dailey ,1239,7,10,1982,1992,10,-0.3
Qyntel Woods ,1240,21,4,2002,2003,1,0.2
Qyntel Woods ,1240,21,4,2002,2004,2,-0.2
Qyntel Woods ,1240,21,4,2002,2005,3,0
Qyntel Woods ,1240,21,4,2002,2006,4,1.3
R.J. Hunter ,1241,28,1,2015,2016,1,0.3
Raef LaFrentz ,1242,3,10,1998,1999,1,1.2
Raef LaFrentz ,1242,3,10,1998,2000,2,5.9
Raef LaFrentz ,1242,3,10,1998,2001,3,6.8
Raef LaFrentz ,1242,3,10,1998,2002,4,6.4
Raef LaFrentz ,1242,3,10,1998,2003,5,5.8
Raef LaFrentz ,1242,3,10,1998,2004,6,0.9
Raef LaFrentz ,1242,3,10,1998,2005,7,7.5
Raef LaFrentz ,1242,3,10,1998,2006,8,4.3
Raef LaFrentz ,1242,3,10,1998,2007,9,0.2
Raef LaFrentz ,1242,3,10,1998,2008,10,0.5
Rafael Addison ,1243,39,6,1986,1987,1,0.4
Rafael Addison ,1243,39,6,1986,1992,6,1.5
Rafael Addison ,1243,39,6,1986,1993,7,0.9
Rafael Addison ,1243,39,6,1986,1995,9,1.5
Rafael Addison ,1243,39,6,1986,1996,10,0.2
Rafael Addison ,1243,39,6,1986,1997,11,0.4
Rafael Araujo ,1244,8,3,2004,2005,1,0.3
Rafael Araujo ,1244,8,3,2004,2006,2,-0.8
Rafael Araujo ,1244,8,3,2004,2007,3,0.1
Rafer Alston ,1245,39,11,1998,2000,2,-0.7
Rafer Alston ,1245,39,11,1998,2001,3,0.3
Rafer Alston ,1245,39,11,1998,2002,4,0.7
Rafer Alston ,1245,39,11,1998,2003,5,1.2
Rafer Alston ,1245,39,11,1998,2004,6,5.9
Rafer Alston ,1245,39,11,1998,2005,7,5.5
Rafer Alston ,1245,39,11,1998,2006,8,3.4
Rafer Alston ,1245,39,11,1998,2007,9,6.6
Rafer Alston ,1245,39,11,1998,2008,10,5
Rafer Alston ,1245,39,11,1998,2009,11,5.3
Rafer Alston ,1245,39,11,1998,2010,12,-0.4
Rajon Rondo ,1246,21,10,2006,2007,1,2.4
Rajon Rondo ,1246,21,10,2006,2008,2,7.2
Rajon Rondo ,1246,21,10,2006,2009,3,9.9
Rajon Rondo ,1246,21,10,2006,2010,4,9.6
Rajon Rondo ,1246,21,10,2006,2011,5,6.6
Rajon Rondo ,1246,21,10,2006,2012,6,4.9
Rajon Rondo ,1246,21,10,2006,2013,7,3.2
Rajon Rondo ,1246,21,10,2006,2014,8,1.1
Rajon Rondo ,1246,21,10,2006,2015,9,1.6
Rajon Rondo ,1246,21,10,2006,2016,10,4.6
Rakeem Christmas ,1247,36,1,2015,2016,1,0
Randolph Childress ,1248,19,2,1995,1996,1,0
Randolph Childress ,1248,19,2,1995,1997,2,-0.2
Randolph Keys ,1249,22,5,1988,1989,1,0.3
Randolph Keys ,1249,22,5,1988,1990,2,1
Randolph Keys ,1249,22,5,1988,1991,3,-0.2
Randolph Keys ,1249,22,5,1988,1995,7,0
Randolph Keys ,1249,22,5,1988,1996,8,1.2
Randy Breuer ,1250,18,11,1983,1984,1,0.3
Randy Breuer ,1250,18,11,1983,1985,2,3
Randy Breuer ,1250,18,11,1983,1986,3,4.5
Randy Breuer ,1250,18,11,1983,1987,4,2.4
Randy Breuer ,1250,18,11,1983,1988,5,5.1
Randy Breuer ,1250,18,11,1983,1989,6,0.9
Randy Breuer ,1250,18,11,1983,1990,7,2
Randy Breuer ,1250,18,11,1983,1991,8,1
Randy Breuer ,1250,18,11,1983,1992,9,1.7
Randy Breuer ,1250,18,11,1983,1993,10,0.1
Randy Breuer ,1250,18,11,1983,1994,11,0
Randy Brown ,1251,31,12,1991,1992,1,0.3
Randy Brown ,1251,31,12,1991,1993,2,1.9
Randy Brown ,1251,31,12,1991,1994,3,0.4
Randy Brown ,1251,31,12,1991,1995,4,1.6
Randy Brown ,1251,31,12,1991,1996,5,1.5
Randy Brown ,1251,31,12,1991,1997,6,2.4
Randy Brown ,1251,31,12,1991,1998,7,1.8
Randy Brown ,1251,31,12,1991,1999,8,1
Randy Brown ,1251,31,12,1991,2000,9,-0.8
Randy Brown ,1251,31,12,1991,2001,10,0.9
Randy Brown ,1251,31,12,1991,2002,11,0
Randy Brown ,1251,31,12,1991,2003,12,0.2
Randy Foye ,1252,7,10,2006,2007,1,2.3
Randy Foye ,1252,7,10,2006,2008,2,1.1
Randy Foye ,1252,7,10,2006,2009,3,3.1
Randy Foye ,1252,7,10,2006,2010,4,2.2
Randy Foye ,1252,7,10,2006,2011,5,1.7
Randy Foye ,1252,7,10,2006,2012,6,3.2
Randy Foye ,1252,7,10,2006,2013,7,3.7
Randy Foye ,1252,7,10,2006,2014,8,4.6
Randy Foye ,1252,7,10,2006,2015,9,1
Randy Foye ,1252,7,10,2006,2016,10,0.4
Randy Livingston ,1253,42,11,1996,1997,1,0.3
Randy Livingston ,1253,42,11,1996,1998,2,0
Randy Livingston ,1253,42,11,1996,1999,3,0.1
Randy Livingston ,1253,42,11,1996,2000,4,1.5
Randy Livingston ,1253,42,11,1996,2001,5,0
Randy Livingston ,1253,42,11,1996,2002,6,0.2
Randy Livingston ,1253,42,11,1996,2003,7,0.1
Randy Livingston ,1253,42,11,1996,2004,8,-0.1
Randy Livingston ,1253,42,11,1996,2005,9,0.4
Randy Livingston ,1253,42,11,1996,2006,10,0
Randy Livingston ,1253,42,11,1996,2007,11,-0.1
Randy White ,1254,8,5,1989,1990,1,-0.2
Randy White ,1254,8,5,1989,1991,2,0.7
Randy White ,1254,8,5,1989,1992,3,0.4
Randy White ,1254,8,5,1989,1993,4,0.8
Randy White ,1254,8,5,1989,1994,5,0.2
Randy Wittman ,1255,22,9,1983,1984,1,1.2
Randy Wittman ,1255,22,9,1983,1985,2,1.6
Randy Wittman ,1255,22,9,1983,1986,3,5.9
Randy Wittman ,1255,22,9,1983,1987,4,4.2
Randy Wittman ,1255,22,9,1983,1988,5,3.5
Randy Wittman ,1255,22,9,1983,1989,6,0.7
Randy Wittman ,1255,22,9,1983,1990,7,0
Randy Wittman ,1255,22,9,1983,1991,8,0
Randy Wittman ,1255,22,9,1983,1992,9,0
Randy Woods ,1256,16,4,1992,1993,1,0.1
Randy Woods ,1256,16,4,1992,1994,2,0.3
Randy Woods ,1256,16,4,1992,1995,3,0.2
Randy Woods ,1256,16,4,1992,1996,4,0.1
Rashad McCants ,1257,14,4,2005,2006,1,1.6
Rashad McCants ,1257,14,4,2005,2007,2,-0.3
Rashad McCants ,1257,14,4,2005,2008,3,1.7
Rashad McCants ,1257,14,4,2005,2009,4,0.6
Rashad Vaughn ,1258,17,1,2015,2016,1,-0.8
Rashard Lewis ,1259,32,16,1998,1999,1,-0.4
Rashard Lewis ,1259,32,16,1998,2000,2,4.1
Rashard Lewis ,1259,32,16,1998,2001,3,8
Rashard Lewis ,1259,32,16,1998,2002,4,8.6
Rashard Lewis ,1259,32,16,1998,2003,5,7.8
Rashard Lewis ,1259,32,16,1998,2004,6,6.5
Rashard Lewis ,1259,32,16,1998,2005,7,8.4
Rashard Lewis ,1259,32,16,1998,2006,8,8.3
Rashard Lewis ,1259,32,16,1998,2007,9,7.6
Rashard Lewis ,1259,32,16,1998,2008,10,9.8
Rashard Lewis ,1259,32,16,1998,2009,11,9.5
Rashard Lewis ,1259,32,16,1998,2010,12,6.5
Rashard Lewis ,1259,32,16,1998,2011,13,3
Rashard Lewis ,1259,32,16,1998,2012,14,0.3
Rashard Lewis ,1259,32,16,1998,2013,15,1.2
Rashard Lewis ,1259,32,16,1998,2014,16,1.7
Rasheed Wallace ,1260,4,16,1995,1996,1,2.3
Rasheed Wallace ,1260,4,16,1995,1997,2,6.4
Rasheed Wallace ,1260,4,16,1995,1998,3,7.6
Rasheed Wallace ,1260,4,16,1995,1999,4,5
Rasheed Wallace ,1260,4,16,1995,2000,5,9.3
Rasheed Wallace ,1260,4,16,1995,2001,6,11
Rasheed Wallace ,1260,4,16,1995,2002,7,9.7
Rasheed Wallace ,1260,4,16,1995,2003,8,8.5
Rasheed Wallace ,1260,4,16,1995,2004,9,6.2
Rasheed Wallace ,1260,4,16,1995,2005,10,7.1
Rasheed Wallace ,1260,4,16,1995,2006,11,8.9
Rasheed Wallace ,1260,4,16,1995,2007,12,6.2
Rasheed Wallace ,1260,4,16,1995,2008,13,7.6
Rasheed Wallace ,1260,4,16,1995,2009,14,5.1
Rasheed Wallace ,1260,4,16,1995,2010,15,3.6
Rasheed Wallace ,1260,4,16,1995,2013,18,0.6
Rasho Nesterovic ,1261,17,12,1998,1999,1,0
Rasho Nesterovic ,1261,17,12,1998,2000,2,3
Rasho Nesterovic ,1261,17,12,1998,2001,3,1.5
Rasho Nesterovic ,1261,17,12,1998,2002,4,4.1
Rasho Nesterovic ,1261,17,12,1998,2003,5,5.2
Rasho Nesterovic ,1261,17,12,1998,2004,6,7.2
Rasho Nesterovic ,1261,17,12,1998,2005,7,4.2
Rasho Nesterovic ,1261,17,12,1998,2006,8,3.7
Rasho Nesterovic ,1261,17,12,1998,2007,9,4.1
Rasho Nesterovic ,1261,17,12,1998,2008,10,3.9
Rasho Nesterovic ,1261,17,12,1998,2009,11,2.2
Rasho Nesterovic ,1261,17,12,1998,2010,12,0.8
Raul Lopez ,1262,24,2,2001,2004,3,1.4
Raul Lopez ,1262,24,2,2001,2005,4,0.7
Raul Neto ,1263,47,1,2013,2016,3,1.8
Ray Allen ,1264,5,18,1996,1997,1,4.9
Ray Allen ,1264,5,18,1996,1998,2,7
Ray Allen ,1264,5,18,1996,1999,3,5.2
Ray Allen ,1264,5,18,1996,2000,4,10.1
Ray Allen ,1264,5,18,1996,2001,5,13.7
Ray Allen ,1264,5,18,1996,2002,6,8.9
Ray Allen ,1264,5,18,1996,2003,7,9.1
Ray Allen ,1264,5,18,1996,2004,8,6.9
Ray Allen ,1264,5,18,1996,2005,9,10.7
Ray Allen ,1264,5,18,1996,2006,10,9.5
Ray Allen ,1264,5,18,1996,2007,11,6.3
Ray Allen ,1264,5,18,1996,2008,12,9.7
Ray Allen ,1264,5,18,1996,2009,13,11.1
Ray Allen ,1264,5,18,1996,2010,14,7.9
Ray Allen ,1264,5,18,1996,2011,15,10
Ray Allen ,1264,5,18,1996,2012,16,4.7
Ray Allen ,1264,5,18,1996,2013,17,5.4
Ray Allen ,1264,5,18,1996,2014,18,4.1
Ray Blume ,1265,36,1,1981,1982,1,-0.1
Ray McCallum ,1266,36,3,2013,2014,1,0.4
Ray McCallum ,1266,36,3,2013,2015,2,1.4
Ray McCallum ,1266,36,3,2013,2016,3,0.3
Ray Tolbert ,1267,18,5,1981,1982,1,0.7
Ray Tolbert ,1267,18,5,1981,1983,2,1.1
Ray Tolbert ,1267,18,5,1981,1984,3,0.8
Ray Tolbert ,1267,18,5,1981,1988,7,0.3
Ray Tolbert ,1267,18,5,1981,1989,8,0
Raymond Felton ,1268,5,11,2005,2006,1,2.6
Raymond Felton ,1268,5,11,2005,2007,2,2.3
Raymond Felton ,1268,5,11,2005,2008,3,3.4
Raymond Felton ,1268,5,11,2005,2009,4,4.3
Raymond Felton ,1268,5,11,2005,2010,5,6.5
Raymond Felton ,1268,5,11,2005,2011,6,5.4
Raymond Felton ,1268,5,11,2005,2012,7,1.7
Raymond Felton ,1268,5,11,2005,2013,8,4.2
Raymond Felton ,1268,5,11,2005,2014,9,2.2
Raymond Felton ,1268,5,11,2005,2015,10,0.2
Raymond Felton ,1268,5,11,2005,2016,11,2.7
Raymond Townsend ,1269,22,3,1978,1979,1,0.8
Raymond Townsend ,1269,22,3,1978,1980,2,0.4
Raymond Townsend ,1269,22,3,1978,1982,4,-0.2
Reece Gaines ,1270,15,3,2003,2004,1,-0.5
Reece Gaines ,1270,15,3,2003,2005,2,-0.1
Reece Gaines ,1270,15,3,2003,2006,3,0
Reggie Bullock ,1271,25,3,2013,2014,1,0.2
Reggie Bullock ,1271,25,3,2013,2015,2,0.1
Reggie Bullock ,1271,25,3,2013,2016,3,1.2
Reggie Carter ,1272,27,2,1979,1981,2,0.1
Reggie Carter ,1272,27,2,1979,1982,3,0.3
Reggie Jackson ,1273,24,5,2011,2012,1,0.1
Reggie Jackson ,1273,24,5,2011,2013,2,2.5
Reggie Jackson ,1273,24,5,2011,2014,3,4.9
Reggie Jackson ,1273,24,5,2011,2015,4,4.9
Reggie Jackson ,1273,24,5,2011,2016,5,6.9
Reggie Johnson ,1274,15,4,1980,1981,1,3
Reggie Johnson ,1274,15,4,1980,1982,2,3.9
Reggie Johnson ,1274,15,4,1980,1983,3,2.4
Reggie Johnson ,1274,15,4,1980,1984,4,1.6
Reggie King ,1275,18,6,1979,1980,1,6.2
Reggie King ,1275,18,6,1979,1981,2,8.3
Reggie King ,1275,18,6,1979,1982,3,4.8
Reggie King ,1275,18,6,1979,1983,4,1.6
Reggie King ,1275,18,6,1979,1984,5,3.4
Reggie King ,1275,18,6,1979,1985,6,0.5
Reggie Lewis ,1276,22,6,1987,1988,1,0.4
Reggie Lewis ,1276,22,6,1987,1989,2,6.9
Reggie Lewis ,1276,22,6,1987,1990,3,6.7
Reggie Lewis ,1276,22,6,1987,1991,4,7.5
Reggie Lewis ,1276,22,6,1987,1992,5,9.1
Reggie Lewis ,1276,22,6,1987,1993,6,8.3
Reggie Smith ,1277,31,2,1992,1993,1,0
Reggie Smith ,1277,31,2,1992,1994,2,0.4
Reggie Theus ,1278,9,13,1978,1979,1,3.2
Reggie Theus ,1278,9,13,1978,1980,2,6.9
Reggie Theus ,1278,9,13,1978,1981,3,9.2
Reggie Theus ,1278,9,13,1978,1982,4,5.3
Reggie Theus ,1278,9,13,1978,1983,5,6.5
Reggie Theus ,1278,9,13,1978,1984,6,1.8
Reggie Theus ,1278,9,13,1978,1985,7,4.6
Reggie Theus ,1278,9,13,1978,1986,8,6.4
Reggie Theus ,1278,9,13,1978,1987,9,6.2
Reggie Theus ,1278,9,13,1978,1988,10,3.7
Reggie Theus ,1278,9,13,1978,1989,11,5.9
Reggie Theus ,1278,9,13,1978,1990,12,2.5
Reggie Theus ,1278,9,13,1978,1991,13,4.7
Reggie Williams ,1279,4,10,1987,1988,1,-1.1
Reggie Williams ,1279,4,10,1987,1989,2,0.4
Reggie Williams ,1279,4,10,1987,1990,3,0
Reggie Williams ,1279,4,10,1987,1991,4,3.3
Reggie Williams ,1279,4,10,1987,1992,5,6.6
Reggie Williams ,1279,4,10,1987,1993,6,5.9
Reggie Williams ,1279,4,10,1987,1994,7,4.8
Reggie Williams ,1279,4,10,1987,1995,8,5.8
Reggie Williams ,1279,4,10,1987,1996,9,0.3
Reggie Williams ,1279,4,10,1987,1997,10,0.1
Reggie Williams ,1279,4,10,1987,2010,23,1.7
Reggie Williams ,1279,4,10,1987,2011,24,3.7
Reggie Williams ,1279,4,10,1987,2012,25,0.3
Reggie Williams ,1279,4,10,1987,2013,26,0.3
Reggie Williams ,1279,4,10,1987,2014,27,0
Reggie Williams ,1279,4,10,1987,2015,28,0.2
Renaldo Balkman ,1280,20,6,2006,2007,1,2.8
Renaldo Balkman ,1280,20,6,2006,2008,2,1.3
Renaldo Balkman ,1280,20,6,2006,2009,3,2.6
Renaldo Balkman ,1280,20,6,2006,2010,4,0
Renaldo Balkman ,1280,20,6,2006,2011,5,0.1
Renaldo Balkman ,1280,20,6,2006,2012,6,0.3
Rex Chapman ,1281,8,12,1988,1989,1,-0.2
Rex Chapman ,1281,8,12,1988,1990,2,-0.7
Rex Chapman ,1281,8,12,1988,1991,3,3
Rex Chapman ,1281,8,12,1988,1992,4,0.1
Rex Chapman ,1281,8,12,1988,1993,5,1.9
Rex Chapman ,1281,8,12,1988,1994,6,3.9
Rex Chapman ,1281,8,12,1988,1995,7,2.5
Rex Chapman ,1281,8,12,1988,1996,8,4.2
Rex Chapman ,1281,8,12,1988,1997,9,3.3
Rex Chapman ,1281,8,12,1988,1998,10,4.5
Rex Chapman ,1281,8,12,1988,1999,11,0.9
Rex Chapman ,1281,8,12,1988,2000,12,1.4
Rex Walters ,1282,16,7,1993,1994,1,1.2
Rex Walters ,1282,16,7,1993,1995,2,1.6
Rex Walters ,1282,16,7,1993,1996,3,0.9
Rex Walters ,1282,16,7,1993,1997,4,1.6
Rex Walters ,1282,16,7,1993,1998,5,0.4
Rex Walters ,1282,16,7,1993,1999,6,0.5
Rex Walters ,1282,16,7,1993,2000,7,0.3
Rich King ,1283,14,4,1991,1992,1,0.2
Rich King ,1283,14,4,1991,1993,2,0
Rich King ,1283,14,4,1991,1994,3,0.1
Rich King ,1283,14,4,1991,1995,4,-0.1
Rich Manning ,1284,40,2,1993,1996,3,-0.2
Rich Manning ,1284,40,2,1993,1997,4,-0.1
Richard Anderson ,1285,32,6,1982,1983,1,0.5
Richard Anderson ,1285,32,6,1982,1984,2,1.3
Richard Anderson ,1285,32,6,1982,1987,5,0.5
Richard Anderson ,1285,32,6,1982,1988,6,2.3
Richard Anderson ,1285,32,6,1982,1989,7,2.1
Richard Anderson ,1285,32,6,1982,1990,8,1
Richard Dumas ,1286,46,3,1991,1993,2,3.9
Richard Dumas ,1286,46,3,1991,1995,4,0.3
Richard Dumas ,1286,46,3,1991,1996,5,0.3
Richard Hamilton ,1287,7,14,1999,2000,1,0.7
Richard Hamilton ,1287,7,14,1999,2001,2,2.4
Richard Hamilton ,1287,7,14,1999,2002,3,4
Richard Hamilton ,1287,7,14,1999,2003,4,7.3
Richard Hamilton ,1287,7,14,1999,2004,5,8.1
Richard Hamilton ,1287,7,14,1999,2005,6,7.4
Richard Hamilton ,1287,7,14,1999,2006,7,7.6
Richard Hamilton ,1287,7,14,1999,2007,8,8.1
Richard Hamilton ,1287,7,14,1999,2008,9,7.7
Richard Hamilton ,1287,7,14,1999,2009,10,4.5
Richard Hamilton ,1287,7,14,1999,2010,11,1.4
Richard Hamilton ,1287,7,14,1999,2011,12,1.8
Richard Hamilton ,1287,7,14,1999,2012,13,1.3
Richard Hamilton ,1287,7,14,1999,2013,14,0.4
Richard Jefferson ,1288,13,15,2001,2002,1,4.7
Richard Jefferson ,1288,13,15,2001,2003,2,9.9
Richard Jefferson ,1288,13,15,2001,2004,3,11
Richard Jefferson ,1288,13,15,2001,2005,4,2.4
Richard Jefferson ,1288,13,15,2001,2006,5,11.7
Richard Jefferson ,1288,13,15,2001,2007,6,3.4
Richard Jefferson ,1288,13,15,2001,2008,7,7.6
Richard Jefferson ,1288,13,15,2001,2009,8,6.6
Richard Jefferson ,1288,13,15,2001,2010,9,6
Richard Jefferson ,1288,13,15,2001,2011,10,5.9
Richard Jefferson ,1288,13,15,2001,2012,11,3.1
Richard Jefferson ,1288,13,15,2001,2013,12,1
Richard Jefferson ,1288,13,15,2001,2014,13,2.7
Richard Jefferson ,1288,13,15,2001,2015,14,2.3
Richard Jefferson ,1288,13,15,2001,2016,15,2.7
Richard Petruska ,1289,46,1,1993,1994,1,0
Richaun Holmes ,1290,37,1,2015,2016,1,1.5
Rick Fox ,1291,24,13,1991,1992,1,2.3
Rick Fox ,1291,24,13,1991,1993,2,2.1
Rick Fox ,1291,24,13,1991,1994,3,3.2
Rick Fox ,1291,24,13,1991,1995,4,2.8
Rick Fox ,1291,24,13,1991,1996,5,5.1
Rick Fox ,1291,24,13,1991,1997,6,5.2
Rick Fox ,1291,24,13,1991,1998,7,5.3
Rick Fox ,1291,24,13,1991,1999,8,1.8
Rick Fox ,1291,24,13,1991,2000,9,3.2
Rick Fox ,1291,24,13,1991,2001,10,5.1
Rick Fox ,1291,24,13,1991,2002,11,4.3
Rick Fox ,1291,24,13,1991,2003,12,3.6
Rick Fox ,1291,24,13,1991,2004,13,0.8
Rick Mahorn ,1292,35,18,1980,1981,1,1.8
Rick Mahorn ,1292,35,18,1980,1982,2,5.9
Rick Mahorn ,1292,35,18,1980,1983,3,6.2
Rick Mahorn ,1292,35,18,1980,1984,4,4.8
Rick Mahorn ,1292,35,18,1980,1985,5,3.6
Rick Mahorn ,1292,35,18,1980,1986,6,1.3
Rick Mahorn ,1292,35,18,1980,1987,7,2.5
Rick Mahorn ,1292,35,18,1980,1988,8,5.9
Rick Mahorn ,1292,35,18,1980,1989,9,4.6
Rick Mahorn ,1292,35,18,1980,1990,10,5.3
Rick Mahorn ,1292,35,18,1980,1991,11,4.4
Rick Mahorn ,1292,35,18,1980,1993,13,2.3
Rick Mahorn ,1292,35,18,1980,1994,14,0.5
Rick Mahorn ,1292,35,18,1980,1995,15,1.2
Rick Mahorn ,1292,35,18,1980,1996,16,0.1
Rick Mahorn ,1292,35,18,1980,1997,17,0.3
Rick Mahorn ,1292,35,18,1980,1998,18,0.9
Rick Mahorn ,1292,35,18,1980,1999,19,0
Rick Robey ,1293,3,8,1978,1979,1,3.1
Rick Robey ,1293,3,8,1978,1980,2,5.5
Rick Robey ,1293,3,8,1978,1981,3,3.7
Rick Robey ,1293,3,8,1978,1982,4,1.9
Rick Robey ,1293,3,8,1978,1983,5,0.9
Rick Robey ,1293,3,8,1978,1984,6,1.4
Rick Robey ,1293,3,8,1978,1985,7,-0.2
Rick Robey ,1293,3,8,1978,1986,8,-0.6
Rick Wilson ,1294,25,2,1978,1979,1,0.3
Rick Wilson ,1294,25,2,1978,1980,2,-0.2
Rickey Brown ,1295,13,5,1980,1981,1,0.9
Rickey Brown ,1295,13,5,1980,1982,2,1.8
Rickey Brown ,1295,13,5,1980,1983,3,0.7
Rickey Brown ,1295,13,5,1980,1984,4,0.9
Rickey Brown ,1295,13,5,1980,1985,5,0.4
Rickie Winslow ,1296,28,1,1987,1988,1,-0.2
Ricky Berry ,1297,18,1,1988,1989,1,2.4
Ricky Blanton ,1298,46,1,1989,1993,4,0
Ricky Davis ,1299,21,12,1998,1999,1,0.2
Ricky Davis ,1299,21,12,1998,2000,2,1.1
Ricky Davis ,1299,21,12,1998,2001,3,0.2
Ricky Davis ,1299,21,12,1998,2002,4,2.8
Ricky Davis ,1299,21,12,1998,2003,5,3
Ricky Davis ,1299,21,12,1998,2004,6,4.4
Ricky Davis ,1299,21,12,1998,2005,7,4.2
Ricky Davis ,1299,21,12,1998,2006,8,5
Ricky Davis ,1299,21,12,1998,2007,9,5.7
Ricky Davis ,1299,21,12,1998,2008,10,1.9
Ricky Davis ,1299,21,12,1998,2009,11,-0.4
Ricky Davis ,1299,21,12,1998,2010,12,0.1
Ricky Ledo ,1300,43,2,2013,2014,1,0
Ricky Ledo ,1300,43,2,2013,2015,2,-0.6
Ricky Pierce ,1301,18,16,1982,1983,1,-0.1
Ricky Pierce ,1301,18,16,1982,1984,2,1.8
Ricky Pierce ,1301,18,16,1982,1985,3,3
Ricky Pierce ,1301,18,16,1982,1986,4,8.3
Ricky Pierce ,1301,18,16,1982,1987,5,9.4
Ricky Pierce ,1301,18,16,1982,1988,6,2.2
Ricky Pierce ,1301,18,16,1982,1989,7,6.7
Ricky Pierce ,1301,18,16,1982,1990,8,5.8
Ricky Pierce ,1301,18,16,1982,1991,9,7.9
Ricky Pierce ,1301,18,16,1982,1992,10,7.8
Ricky Pierce ,1301,18,16,1982,1993,11,7.7
Ricky Pierce ,1301,18,16,1982,1994,12,4
Ricky Pierce ,1301,18,16,1982,1995,13,1.5
Ricky Pierce ,1301,18,16,1982,1996,14,3.1
Ricky Pierce ,1301,18,16,1982,1997,15,2.7
Ricky Pierce ,1301,18,16,1982,1998,16,0.3
Ricky Rubio ,1302,5,5,2009,2012,3,2
Ricky Rubio ,1302,5,5,2009,2013,4,3
Ricky Rubio ,1302,5,5,2009,2014,5,5.9
Ricky Rubio ,1302,5,5,2009,2015,6,0.5
Ricky Rubio ,1302,5,5,2009,2016,7,5.8
Rik Smits ,1303,2,12,1988,1989,1,4.3
Rik Smits ,1303,2,12,1988,1990,2,6.6
Rik Smits ,1303,2,12,1988,1991,3,2.9
Rik Smits ,1303,2,12,1988,1992,4,3.4
Rik Smits ,1303,2,12,1988,1993,5,2.7
Rik Smits ,1303,2,12,1988,1994,6,7.8
Rik Smits ,1303,2,12,1988,1995,7,7.2
Rik Smits ,1303,2,12,1988,1996,8,5
Rik Smits ,1303,2,12,1988,1997,9,3.3
Rik Smits ,1303,2,12,1988,1998,10,6.1
Rik Smits ,1303,2,12,1988,1999,11,3.4
Rik Smits ,1303,2,12,1988,2000,12,3.8
Rob Williams ,1304,19,2,1982,1983,1,-0.1
Rob Williams ,1304,19,2,1982,1984,2,2.2
Robert Archibald ,1305,31,2,2002,2003,1,-0.2
Robert Archibald ,1305,31,2,2002,2004,2,0.2
Robert Horry ,1306,11,16,1992,1993,1,3.6
Robert Horry ,1306,11,16,1992,1994,2,5.9
Robert Horry ,1306,11,16,1992,1995,3,4.2
Robert Horry ,1306,11,16,1992,1996,4,4.9
Robert Horry ,1306,11,16,1992,1997,5,2.9
Robert Horry ,1306,11,16,1992,1998,6,6.6
Robert Horry ,1306,11,16,1992,1999,7,1.7
Robert Horry ,1306,11,16,1992,2000,8,5.7
Robert Horry ,1306,11,16,1992,2001,9,2.6
Robert Horry ,1306,11,16,1992,2002,10,6.9
Robert Horry ,1306,11,16,1992,2003,11,4.8
Robert Horry ,1306,11,16,1992,2004,12,4.6
Robert Horry ,1306,11,16,1992,2005,13,4.6
Robert Horry ,1306,11,16,1992,2006,14,3.6
Robert Horry ,1306,11,16,1992,2007,15,2.9
Robert Horry ,1306,11,16,1992,2008,16,1.1
Robert Swift ,1307,12,4,2004,2005,1,0
Robert Swift ,1307,12,4,2004,2006,2,1.1
Robert Swift ,1307,12,4,2004,2008,4,-0.2
Robert Swift ,1307,12,4,2004,2009,5,0.7
Robert Traylor ,1308,6,7,1998,1999,1,2.5
Robert Traylor ,1308,6,7,1998,2000,2,1
Robert Traylor ,1308,6,7,1998,2001,3,1.9
Robert Traylor ,1308,6,7,1998,2002,4,1.2
Robert Traylor ,1308,6,7,1998,2003,5,2.4
Robert Traylor ,1308,6,7,1998,2004,6,2.5
Robert Traylor ,1308,6,7,1998,2005,7,1.8
Robert Werdann ,1309,46,3,1992,1993,1,-0.1
Robert Werdann ,1309,46,3,1992,1996,4,0.2
Robert Werdann ,1309,46,3,1992,1997,5,0
Robin Lopez ,1310,15,8,2008,2009,1,1.1
Robin Lopez ,1310,15,8,2008,2010,2,3.2
Robin Lopez ,1310,15,8,2008,2011,3,1.5
Robin Lopez ,1310,15,8,2008,2012,4,2.1
Robin Lopez ,1310,15,8,2008,2013,5,5.6
Robin Lopez ,1310,15,8,2008,2014,6,9.5
Robin Lopez ,1310,15,8,2008,2015,7,5.1
Robin Lopez ,1310,15,8,2008,2016,8,5.8
Rod Foster ,1311,28,3,1983,1984,1,1.6
Rod Foster ,1311,28,3,1983,1985,2,0.9
Rod Foster ,1311,28,3,1983,1986,3,-0.3
Rod Higgins ,1312,31,13,1982,1983,1,3.8
Rod Higgins ,1312,31,13,1982,1984,2,2
Rod Higgins ,1312,31,13,1982,1985,3,1
Rod Higgins ,1312,31,13,1982,1986,4,0.1
Rod Higgins ,1312,31,13,1982,1987,5,3.7
Rod Higgins ,1312,31,13,1982,1988,6,5.7
Rod Higgins ,1312,31,13,1982,1989,7,5.9
Rod Higgins ,1312,31,13,1982,1990,8,5
Rod Higgins ,1312,31,13,1982,1991,9,5.3
Rod Higgins ,1312,31,13,1982,1992,10,1.3
Rod Higgins ,1312,31,13,1982,1993,11,2.5
Rod Higgins ,1312,31,13,1982,1994,12,1.4
Rod Higgins ,1312,31,13,1982,1995,13,0
Rod Strickland ,1313,19,17,1988,1989,1,3.7
Rod Strickland ,1313,19,17,1988,1990,2,4.3
Rod Strickland ,1313,19,17,1988,1991,3,5.7
Rod Strickland ,1313,19,17,1988,1992,4,5.2
Rod Strickland ,1313,19,17,1988,1993,5,7.4
Rod Strickland ,1313,19,17,1988,1994,6,9.3
Rod Strickland ,1313,19,17,1988,1995,7,8.5
Rod Strickland ,1313,19,17,1988,1996,8,7.1
Rod Strickland ,1313,19,17,1988,1997,9,8.8
Rod Strickland ,1313,19,17,1988,1998,10,8.1
Rod Strickland ,1313,19,17,1988,1999,11,4.1
Rod Strickland ,1313,19,17,1988,2000,12,3.7
Rod Strickland ,1313,19,17,1988,2001,13,2.2
Rod Strickland ,1313,19,17,1988,2002,14,4.9
Rod Strickland ,1313,19,17,1988,2003,15,1.7
Rod Strickland ,1313,19,17,1988,2004,16,1.3
Rod Strickland ,1313,19,17,1988,2005,17,-0.2
Rodney Carney ,1314,16,5,2006,2007,1,1.3
Rodney Carney ,1314,16,5,2006,2008,2,1.6
Rodney Carney ,1314,16,5,2006,2009,3,1.5
Rodney Carney ,1314,16,5,2006,2010,4,1.5
Rodney Carney ,1314,16,5,2006,2011,5,0.3
Rodney Hood ,1315,23,2,2014,2015,1,2.2
Rodney Hood ,1315,23,2,2014,2016,2,6
Rodney McCray ,1316,3,10,1983,1984,1,4.6
Rodney McCray ,1316,3,10,1983,1985,2,8.5
Rodney McCray ,1316,3,10,1983,1986,3,6.3
Rodney McCray ,1316,3,10,1983,1987,4,9.4
Rodney McCray ,1316,3,10,1983,1988,5,7.6
Rodney McCray ,1316,3,10,1983,1989,6,2.9
Rodney McCray ,1316,3,10,1983,1990,7,7.9
Rodney McCray ,1316,3,10,1983,1991,8,5.3
Rodney McCray ,1316,3,10,1983,1992,9,2.5
Rodney McCray ,1316,3,10,1983,1993,10,0.9
Rodney Monroe ,1317,30,1,1991,1992,1,-0.2
Rodney Rogers ,1318,9,12,1993,1994,1,2
Rodney Rogers ,1318,9,12,1993,1995,2,3.9
Rodney Rogers ,1318,9,12,1993,1996,3,2.3
Rodney Rogers ,1318,9,12,1993,1997,4,2.9
Rodney Rogers ,1318,9,12,1993,1998,5,3.3
Rodney Rogers ,1318,9,12,1993,1999,6,1.2
Rodney Rogers ,1318,9,12,1993,2000,7,7.4
Rodney Rogers ,1318,9,12,1993,2001,8,4.7
Rodney Rogers ,1318,9,12,1993,2002,9,5.4
Rodney Rogers ,1318,9,12,1993,2003,10,2.3
Rodney Rogers ,1318,9,12,1993,2004,11,3.1
Rodney Rogers ,1318,9,12,1993,2005,12,0.3
Rodney Stuckey ,1319,15,9,2007,2008,1,2
Rodney Stuckey ,1319,15,9,2007,2009,2,3.8
Rodney Stuckey ,1319,15,9,2007,2010,3,2.7
Rodney Stuckey ,1319,15,9,2007,2011,4,5
Rodney Stuckey ,1319,15,9,2007,2012,5,4.5
Rodney Stuckey ,1319,15,9,2007,2013,6,2.5
Rodney Stuckey ,1319,15,9,2007,2014,7,2.2
Rodney Stuckey ,1319,15,9,2007,2015,8,4
Rodney Stuckey ,1319,15,9,2007,2016,9,2
Rodney White ,1320,9,4,2001,2002,1,-0.2
Rodney White ,1320,9,4,2001,2003,2,-0.4
Rodney White ,1320,9,4,2001,2004,3,1.8
Rodney White ,1320,9,4,2001,2005,4,0.5
Rodrick Rhodes ,1321,24,3,1997,1998,1,-0.9
Rodrick Rhodes ,1321,24,3,1997,1999,2,-0.7
Rodrick Rhodes ,1321,24,3,1997,2000,3,-0.1
Rodrigue Beaubois ,1322,25,4,2009,2010,1,2
Rodrigue Beaubois ,1322,25,4,2009,2011,2,0.2
Rodrigue Beaubois ,1322,25,4,2009,2012,3,2.2
Rodrigue Beaubois ,1322,25,4,2009,2013,4,0.4
Roger Mason ,1323,30,10,2002,2003,1,0.1
Roger Mason ,1323,30,10,2002,2004,2,0.1
Roger Mason ,1323,30,10,2002,2007,5,-0.1
Roger Mason ,1323,30,10,2002,2008,6,3.4
Roger Mason ,1323,30,10,2002,2009,7,4.7
Roger Mason ,1323,30,10,2002,2010,8,1.9
Roger Mason ,1323,30,10,2002,2011,9,0.2
Roger Mason ,1323,30,10,2002,2012,10,0.9
Roger Mason ,1323,30,10,2002,2013,11,1.4
Roger Mason ,1323,30,10,2002,2014,12,0.3
Roger Phegley ,1324,14,6,1978,1979,1,0
Roger Phegley ,1324,14,6,1978,1980,2,2.6
Roger Phegley ,1324,14,6,1978,1981,3,3.7
Roger Phegley ,1324,14,6,1978,1982,4,1.6
Roger Phegley ,1324,14,6,1978,1983,5,0.8
Roger Phegley ,1324,14,6,1978,1984,6,-0.1
Roko Ukic ,1325,41,2,2005,2009,4,-0.4
Roko Ukic ,1325,41,2,2005,2010,5,0.2
Rolando Blackman ,1326,9,13,1981,1982,1,4.1
Rolando Blackman ,1326,9,13,1981,1983,2,5.7
Rolando Blackman ,1326,9,13,1981,1984,3,9.8
Rolando Blackman ,1326,9,13,1981,1985,4,7.3
Rolando Blackman ,1326,9,13,1981,1986,5,7
Rolando Blackman ,1326,9,13,1981,1987,6,8
Rolando Blackman ,1326,9,13,1981,1988,7,6.8
Rolando Blackman ,1326,9,13,1981,1989,8,5.7
Rolando Blackman ,1326,9,13,1981,1990,9,6.8
Rolando Blackman ,1326,9,13,1981,1991,10,5.5
Rolando Blackman ,1326,9,13,1981,1992,11,3.8
Rolando Blackman ,1326,9,13,1981,1993,12,2.9
Rolando Blackman ,1326,9,13,1981,1994,13,2.4
Rolando Ferreira ,1327,26,1,1988,1989,1,-0.2
Ron Anderson ,1328,27,10,1984,1985,1,0.3
Ron Anderson ,1328,27,10,1984,1986,2,3.1
Ron Anderson ,1328,27,10,1984,1987,3,1.5
Ron Anderson ,1328,27,10,1984,1988,4,2.5
Ron Anderson ,1328,27,10,1984,1989,5,4.4
Ron Anderson ,1328,27,10,1984,1990,6,3.8
Ron Anderson ,1328,27,10,1984,1991,7,4.1
Ron Anderson ,1328,27,10,1984,1992,8,3.5
Ron Anderson ,1328,27,10,1984,1993,9,0.5
Ron Anderson ,1328,27,10,1984,1994,10,0.5
Ron Brewer ,1329,7,8,1978,1979,1,5.6
Ron Brewer ,1329,7,8,1978,1980,2,4.3
Ron Brewer ,1329,7,8,1978,1981,3,1.4
Ron Brewer ,1329,7,8,1978,1982,4,3.3
Ron Brewer ,1329,7,8,1978,1983,5,1.6
Ron Brewer ,1329,7,8,1978,1984,6,0.3
Ron Brewer ,1329,7,8,1978,1985,7,0.8
Ron Brewer ,1329,7,8,1978,1986,8,0.1
Ron Carter ,1330,26,2,1978,1979,1,0
Ron Carter ,1330,26,2,1978,1980,2,-0.1
Ron Harper ,1331,8,15,1986,1987,1,4.2
Ron Harper ,1331,8,15,1986,1988,2,3.5
Ron Harper ,1331,8,15,1986,1989,3,10.2
Ron Harper ,1331,8,15,1986,1990,4,3.9
Ron Harper ,1331,8,15,1986,1991,5,0.9
Ron Harper ,1331,8,15,1986,1992,6,5.6
Ron Harper ,1331,8,15,1986,1993,7,6
Ron Harper ,1331,8,15,1986,1994,8,2.9
Ron Harper ,1331,8,15,1986,1995,9,2.4
Ron Harper ,1331,8,15,1986,1996,10,6.3
Ron Harper ,1331,8,15,1986,1997,11,5.7
Ron Harper ,1331,8,15,1986,1998,12,7.2
Ron Harper ,1331,8,15,1986,1999,13,1.2
Ron Harper ,1331,8,15,1986,2000,14,4
Ron Harper ,1331,8,15,1986,2001,15,1.8
Ron Mercer ,1332,6,8,1997,1998,1,4
Ron Mercer ,1332,6,8,1997,1999,2,1.3
Ron Mercer ,1332,6,8,1997,2000,3,1.8
Ron Mercer ,1332,6,8,1997,2001,4,1.8
Ron Mercer ,1332,6,8,1997,2002,5,-1.1
Ron Mercer ,1332,6,8,1997,2003,6,1.3
Ron Mercer ,1332,6,8,1997,2004,7,0.4
Ron Mercer ,1332,6,8,1997,2005,8,-0.1
Ron Moore ,1333,25,1,1987,1988,1,-0.1
Ronald Murray ,1334,41,8,2002,2003,1,-0.3
Ronald Murray ,1334,41,8,2002,2004,2,1.7
Ronald Murray ,1334,41,8,2002,2005,3,-0.3
Ronald Murray ,1334,41,8,2002,2006,4,0.7
Ronald Murray ,1334,41,8,2002,2007,5,1.3
Ronald Murray ,1334,41,8,2002,2008,6,0.4
Ronald Murray ,1334,41,8,2002,2009,7,3.1
Ronald Murray ,1334,41,8,2002,2010,8,1.8
Rondae Hollis-Jefferson ,1335,23,1,2015,2016,1,1.2
Ronnie Brewer ,1336,14,8,2006,2007,1,1.7
Ronnie Brewer ,1336,14,8,2006,2008,2,7.8
Ronnie Brewer ,1336,14,8,2006,2009,3,6.8
Ronnie Brewer ,1336,14,8,2006,2010,4,3.7
Ronnie Brewer ,1336,14,8,2006,2011,5,5.4
Ronnie Brewer ,1336,14,8,2006,2012,6,3.9
Ronnie Brewer ,1336,14,8,2006,2013,7,1.1
Ronnie Brewer ,1336,14,8,2006,2014,8,0
Ronnie Lester ,1337,10,6,1980,1981,1,0
Ronnie Lester ,1337,10,6,1980,1982,2,3.9
Ronnie Lester ,1337,10,6,1980,1983,3,1.7
Ronnie Lester ,1337,10,6,1980,1984,4,0.7
Ronnie Lester ,1337,10,6,1980,1985,5,0.2
Ronnie Lester ,1337,10,6,1980,1986,6,-0.2
Ronnie Murphy ,1338,17,1,1987,1988,1,-0.2
Ronny Turiaf ,1339,37,10,2005,2006,1,0.4
Ronny Turiaf ,1339,37,10,2005,2007,2,3.1
Ronny Turiaf ,1339,37,10,2005,2008,3,4.2
Ronny Turiaf ,1339,37,10,2005,2009,4,3.6
Ronny Turiaf ,1339,37,10,2005,2010,5,1.4
Ronny Turiaf ,1339,37,10,2005,2011,6,3.2
Ronny Turiaf ,1339,37,10,2005,2012,7,0.8
Ronny Turiaf ,1339,37,10,2005,2013,8,1.1
Ronny Turiaf ,1339,37,10,2005,2014,9,1.5
Ronny Turiaf ,1339,37,10,2005,2015,10,0
Rony Seikaly ,1340,9,11,1988,1989,1,-0.5
Rony Seikaly ,1340,9,11,1988,1990,2,3.2
Rony Seikaly ,1340,9,11,1988,1991,3,3
Rony Seikaly ,1340,9,11,1988,1992,4,6.2
Rony Seikaly ,1340,9,11,1988,1993,5,6.5
Rony Seikaly ,1340,9,11,1988,1994,6,6.7
Rony Seikaly ,1340,9,11,1988,1995,7,0.7
Rony Seikaly ,1340,9,11,1988,1996,8,2.3
Rony Seikaly ,1340,9,11,1988,1997,9,6.8
Rony Seikaly ,1340,9,11,1988,1998,10,2.7
Rony Seikaly ,1340,9,11,1988,1999,11,-0.3
Roshown McLeod ,1341,20,3,1998,1999,1,0.3
Roshown McLeod ,1341,20,3,1998,2000,2,-0.4
Roshown McLeod ,1341,20,3,1998,2001,3,0.4
Roy Hamilton ,1342,10,2,1979,1980,1,-0.4
Roy Hamilton ,1342,10,2,1979,1981,2,0
Roy Hibbert ,1343,17,8,2008,2009,1,2.1
Roy Hibbert ,1343,17,8,2008,2010,2,4.1
Roy Hibbert ,1343,17,8,2008,2011,3,3.6
Roy Hibbert ,1343,17,8,2008,2012,4,6.2
Roy Hibbert ,1343,17,8,2008,2013,5,6.1
Roy Hibbert ,1343,17,8,2008,2014,6,5.4
Roy Hibbert ,1343,17,8,2008,2015,7,4.2
Roy Hibbert ,1343,17,8,2008,2016,8,2.2
Roy Hinson ,1344,20,8,1983,1984,1,2.5
Roy Hinson ,1344,20,8,1983,1985,2,5
Roy Hinson ,1344,20,8,1983,1986,3,7.4
Roy Hinson ,1344,20,8,1983,1987,4,4.5
Roy Hinson ,1344,20,8,1983,1988,5,4.5
Roy Hinson ,1344,20,8,1983,1989,6,4.4
Roy Hinson ,1344,20,8,1983,1990,7,1.8
Roy Hinson ,1344,20,8,1983,1991,8,0.1
Roy Marble ,1345,23,2,1989,1990,1,-0.3
Roy Marble ,1345,23,2,1989,1994,5,-0.2
Roy Rogers ,1346,22,3,1996,1997,1,1.4
Roy Rogers ,1346,22,3,1996,1998,2,-0.1
Roy Rogers ,1346,22,3,1996,2000,4,0.4
Roy Tarpley ,1347,7,6,1986,1987,1,3.1
Roy Tarpley ,1347,7,6,1986,1988,2,7.8
Roy Tarpley ,1347,7,6,1986,1989,3,2
Roy Tarpley ,1347,7,6,1986,1990,4,3.5
Roy Tarpley ,1347,7,6,1986,1991,5,0.6
Roy Tarpley ,1347,7,6,1986,1995,9,2.8
Royal Ivey ,1348,37,10,2004,2005,1,0.2
Royal Ivey ,1348,37,10,2004,2006,2,0.7
Royal Ivey ,1348,37,10,2004,2007,3,0.3
Royal Ivey ,1348,37,10,2004,2008,4,0.5
Royal Ivey ,1348,37,10,2004,2009,5,0.9
Royal Ivey ,1348,37,10,2004,2010,6,0.6
Royal Ivey ,1348,37,10,2004,2011,7,0.2
Royal Ivey ,1348,37,10,2004,2012,8,0.2
Royal Ivey ,1348,37,10,2004,2013,9,1
Royal Ivey ,1348,37,10,2004,2014,10,0
Royce White ,1349,16,1,2012,2014,2,0
Ruben Boumtje-Boumtje ,1350,49,3,2001,2002,1,0.2
Ruben Boumtje-Boumtje ,1350,49,3,2001,2003,2,0
Ruben Boumtje-Boumtje ,1350,49,3,2001,2004,3,0
Ruben Patterson ,1351,31,10,1998,1999,1,0.2
Ruben Patterson ,1351,31,10,1998,2000,2,6.7
Ruben Patterson ,1351,31,10,1998,2001,3,5.5
Ruben Patterson ,1351,31,10,1998,2002,4,5.6
Ruben Patterson ,1351,31,10,1998,2003,5,3.2
Ruben Patterson ,1351,31,10,1998,2004,6,3
Ruben Patterson ,1351,31,10,1998,2005,7,3.4
Ruben Patterson ,1351,31,10,1998,2006,8,2.1
Ruben Patterson ,1351,31,10,1998,2007,9,5.4
Ruben Patterson ,1351,31,10,1998,2008,10,0.1
Rudy Fernandez ,1352,24,4,2007,2009,2,6.1
Rudy Fernandez ,1352,24,4,2007,2010,3,3
Rudy Fernandez ,1352,24,4,2007,2011,4,3.8
Rudy Fernandez ,1352,24,4,2007,2012,5,1.2
Rudy Gay ,1353,8,10,2006,2007,1,0.5
Rudy Gay ,1353,8,10,2006,2008,2,5
Rudy Gay ,1353,8,10,2006,2009,3,3.3
Rudy Gay ,1353,8,10,2006,2010,4,6.4
Rudy Gay ,1353,8,10,2006,2011,5,5.5
Rudy Gay ,1353,8,10,2006,2012,6,6
Rudy Gay ,1353,8,10,2006,2013,7,4
Rudy Gay ,1353,8,10,2006,2014,8,4.8
Rudy Gay ,1353,8,10,2006,2015,9,6.1
Rudy Gay ,1353,8,10,2006,2016,10,3.8
Rudy Gobert ,1354,27,3,2013,2014,1,0.4
Rudy Gobert ,1354,27,3,2013,2015,2,9.3
Rudy Gobert ,1354,27,3,2013,2016,3,6.4
Rumeal Robinson ,1355,10,6,1990,1991,1,-0.1
Rumeal Robinson ,1355,10,6,1990,1992,2,2.4
Rumeal Robinson ,1355,10,6,1990,1993,3,1.9
Rumeal Robinson ,1355,10,6,1990,1994,4,-0.6
Rumeal Robinson ,1355,10,6,1990,1996,6,1
Rumeal Robinson ,1355,10,6,1990,1997,7,0.5
Russ Schoene ,1356,45,4,1982,1983,1,1.7
Russ Schoene ,1356,45,4,1982,1987,5,-0.2
Russ Schoene ,1356,45,4,1982,1988,6,1.8
Russ Schoene ,1356,45,4,1982,1989,7,1.3
Russ Smith ,1357,47,2,2014,2015,1,-0.1
Russ Smith ,1357,47,2,2014,2016,2,-0.1
Russell Cross ,1358,6,1,1983,1984,1,0.8
Russell Westbrook ,1359,4,8,2008,2009,1,1.9
Russell Westbrook ,1359,4,8,2008,2010,2,6.1
Russell Westbrook ,1359,4,8,2008,2011,3,9.4
Russell Westbrook ,1359,4,8,2008,2012,4,7.9
Russell Westbrook ,1359,4,8,2008,2013,5,11.6
Russell Westbrook ,1359,4,8,2008,2014,6,5.2
Russell Westbrook ,1359,4,8,2008,2015,7,10.6
Russell Westbrook ,1359,4,8,2008,2016,8,14
Ryan Anderson ,1360,21,8,2008,2009,1,2.5
Ryan Anderson ,1360,21,8,2008,2010,2,3.1
Ryan Anderson ,1360,21,8,2008,2011,3,6.4
Ryan Anderson ,1360,21,8,2008,2012,4,8.9
Ryan Anderson ,1360,21,8,2008,2013,5,6.5
Ryan Anderson ,1360,21,8,2008,2014,6,2.3
Ryan Anderson ,1360,21,8,2008,2015,7,3.5
Ryan Anderson ,1360,21,8,2008,2016,8,3.9
Ryan Gomes ,1361,50,8,2005,2006,1,3.1
Ryan Gomes ,1361,50,8,2005,2007,2,4.2
Ryan Gomes ,1361,50,8,2005,2008,3,4.8
Ryan Gomes ,1361,50,8,2005,2009,4,2.5
Ryan Gomes ,1361,50,8,2005,2010,5,2.4
Ryan Gomes ,1361,50,8,2005,2011,6,2.5
Ryan Gomes ,1361,50,8,2005,2012,7,-0.2
Ryan Gomes ,1361,50,8,2005,2014,9,0
Ryan Hollins ,1362,50,10,2006,2007,1,0.2
Ryan Hollins ,1362,50,10,2006,2008,2,1.1
Ryan Hollins ,1362,50,10,2006,2009,3,1
Ryan Hollins ,1362,50,10,2006,2010,4,1.2
Ryan Hollins ,1362,50,10,2006,2011,5,1.8
Ryan Hollins ,1362,50,10,2006,2012,6,0.2
Ryan Hollins ,1362,50,10,2006,2013,7,1.7
Ryan Hollins ,1362,50,10,2006,2014,8,1.3
Ryan Hollins ,1362,50,10,2006,2015,9,1
Ryan Hollins ,1362,50,10,2006,2016,10,1
Ryan Humphrey ,1363,19,3,2002,2003,1,-0.5
Ryan Humphrey ,1363,19,3,2002,2004,2,0
Ryan Humphrey ,1363,19,3,2002,2005,3,0.1
Ryan Kelly ,1364,48,3,2013,2014,1,2.2
Ryan Kelly ,1364,48,3,2013,2015,2,0.7
Ryan Kelly ,1364,48,3,2013,2016,3,0.1
Ryan Robertson ,1365,45,1,1999,2000,1,0
Ryan Stack ,1366,48,2,1998,1999,1,0.4
Ryan Stack ,1366,48,2,1998,2000,2,-0.1
Salim Stoudamire ,1367,31,3,2005,2006,1,1.2
Salim Stoudamire ,1367,31,3,2005,2007,2,0.8
Salim Stoudamire ,1367,31,3,2005,2008,3,0.3
Sam Bowie ,1368,2,10,1984,1985,1,5.7
Sam Bowie ,1368,2,10,1984,1986,2,2.4
Sam Bowie ,1368,2,10,1984,1987,3,0.1
Sam Bowie ,1368,2,10,1984,1989,5,0.5
Sam Bowie ,1368,2,10,1984,1990,6,4.7
Sam Bowie ,1368,2,10,1984,1991,7,2.6
Sam Bowie ,1368,2,10,1984,1992,8,4.6
Sam Bowie ,1368,2,10,1984,1993,9,4.3
Sam Bowie ,1368,2,10,1984,1994,10,0.8
Sam Bowie ,1368,2,10,1984,1995,11,1.1
Sam Cassell ,1369,24,15,1993,1994,1,2.2
Sam Cassell ,1369,24,15,1993,1995,2,4.7
Sam Cassell ,1369,24,15,1993,1996,3,3.9
Sam Cassell ,1369,24,15,1993,1997,4,3.9
Sam Cassell ,1369,24,15,1993,1998,5,8.3
Sam Cassell ,1369,24,15,1993,1999,6,0.8
Sam Cassell ,1369,24,15,1993,2000,7,9.2
Sam Cassell ,1369,24,15,1993,2001,8,8.5
Sam Cassell ,1369,24,15,1993,2002,9,8.6
Sam Cassell ,1369,24,15,1993,2003,10,9.6
Sam Cassell ,1369,24,15,1993,2004,11,12.1
Sam Cassell ,1369,24,15,1993,2005,12,3.8
Sam Cassell ,1369,24,15,1993,2006,13,7.6
Sam Cassell ,1369,24,15,1993,2007,14,2.8
Sam Cassell ,1369,24,15,1993,2008,15,1.8
Sam Dekker ,1370,18,1,2015,2016,1,0
Sam Jacobson ,1371,26,3,1998,1999,1,0
Sam Jacobson ,1371,26,3,1998,2000,2,0.9
Sam Jacobson ,1371,26,3,1998,2001,3,0.2
Sam Perkins ,1372,4,17,1984,1985,1,5.8
Sam Perkins ,1372,4,17,1984,1986,2,7.3
Sam Perkins ,1372,4,17,1984,1987,3,7.5
Sam Perkins ,1372,4,17,1984,1988,4,6.7
Sam Perkins ,1372,4,17,1984,1989,5,6.4
Sam Perkins ,1372,4,17,1984,1990,6,8.1
Sam Perkins ,1372,4,17,1984,1991,7,8
Sam Perkins ,1372,4,17,1984,1992,8,7.4
Sam Perkins ,1372,4,17,1984,1993,9,6.9
Sam Perkins ,1372,4,17,1984,1994,10,7
Sam Perkins ,1372,4,17,1984,1995,11,8.5
Sam Perkins ,1372,4,17,1984,1996,12,6.9
Sam Perkins ,1372,4,17,1984,1997,13,7.1
Sam Perkins ,1372,4,17,1984,1998,14,4.5
Sam Perkins ,1372,4,17,1984,1999,15,1.7
Sam Perkins ,1372,4,17,1984,2000,16,3.5
Sam Perkins ,1372,4,17,1984,2001,17,2
Sam Vincent ,1373,20,7,1985,1986,1,0.3
Sam Vincent ,1373,20,7,1985,1987,2,0.5
Sam Vincent ,1373,20,7,1985,1988,3,3.3
Sam Vincent ,1373,20,7,1985,1989,4,2.3
Sam Vincent ,1373,20,7,1985,1990,5,2.4
Sam Vincent ,1373,20,7,1985,1991,6,0.9
Sam Vincent ,1373,20,7,1985,1992,7,1.1
Sam Williams ,1374,33,4,1981,1982,1,2.6
Sam Williams ,1374,33,4,1981,1983,2,3.7
Sam Williams ,1374,33,4,1981,1984,3,2.7
Sam Williams ,1374,33,4,1981,1985,4,-0.1
Sam Worthen ,1375,26,2,1980,1981,1,0.7
Sam Worthen ,1375,26,2,1980,1982,2,0
Sam Young ,1376,36,4,2009,2010,1,1.2
Sam Young ,1376,36,4,2009,2011,2,2.9
Sam Young ,1376,36,4,2009,2012,3,0.2
Sam Young ,1376,36,4,2009,2013,4,0.9
Samaki Walker ,1377,9,10,1996,1997,1,0.5
Samaki Walker ,1377,9,10,1996,1998,2,1.4
Samaki Walker ,1377,9,10,1996,1999,3,0.6
Samaki Walker ,1377,9,10,1996,2000,4,2
Samaki Walker ,1377,9,10,1996,2001,5,1.9
Samaki Walker ,1377,9,10,1996,2002,6,5.3
Samaki Walker ,1377,9,10,1996,2003,7,2.1
Samaki Walker ,1377,9,10,1996,2004,8,0.7
Samaki Walker ,1377,9,10,1996,2005,9,-0.1
Samaki Walker ,1377,9,10,1996,2006,10,0
Samuel Dalembert ,1378,26,13,2001,2002,1,0.3
Samuel Dalembert ,1378,26,13,2001,2004,3,6.9
Samuel Dalembert ,1378,26,13,2001,2005,4,3.9
Samuel Dalembert ,1378,26,13,2001,2006,5,3.6
Samuel Dalembert ,1378,26,13,2001,2007,6,6.2
Samuel Dalembert ,1378,26,13,2001,2008,7,6.9
Samuel Dalembert ,1378,26,13,2001,2009,8,4
Samuel Dalembert ,1378,26,13,2001,2010,9,5.2
Samuel Dalembert ,1378,26,13,2001,2011,10,2.9
Samuel Dalembert ,1378,26,13,2001,2012,11,4.1
Samuel Dalembert ,1378,26,13,2001,2013,12,2.2
Samuel Dalembert ,1378,26,13,2001,2014,13,4.9
Samuel Dalembert ,1378,26,13,2001,2015,14,0.3
Sasha Danilovic ,1379,43,2,1992,1996,4,1.5
Sasha Danilovic ,1379,43,2,1992,1997,5,2.8
Sasha Pavlovic ,1380,19,10,2003,2004,1,0.9
Sasha Pavlovic ,1380,19,10,2003,2005,2,0.8
Sasha Pavlovic ,1380,19,10,2003,2006,3,0.5
Sasha Pavlovic ,1380,19,10,2003,2007,4,3.1
Sasha Pavlovic ,1380,19,10,2003,2008,5,0.2
Sasha Pavlovic ,1380,19,10,2003,2009,6,1.7
Sasha Pavlovic ,1380,19,10,2003,2010,7,-1.2
Sasha Pavlovic ,1380,19,10,2003,2011,8,0.3
Sasha Pavlovic ,1380,19,10,2003,2012,9,0.4
Sasha Pavlovic ,1380,19,10,2003,2013,10,0.1
Sasha Vujacic ,1381,27,9,2004,2005,1,0.2
Sasha Vujacic ,1381,27,9,2004,2006,2,2
Sasha Vujacic ,1381,27,9,2004,2007,3,1.8
Sasha Vujacic ,1381,27,9,2004,2008,4,3.6
Sasha Vujacic ,1381,27,9,2004,2009,5,3.7
Sasha Vujacic ,1381,27,9,2004,2010,6,1.4
Sasha Vujacic ,1381,27,9,2004,2011,7,2.1
Sasha Vujacic ,1381,27,9,2004,2014,10,-0.1
Sasha Vujacic ,1381,27,9,2004,2016,12,1.1
Scooter McCray ,1382,36,3,1983,1984,1,0.3
Scooter McCray ,1382,36,3,1983,1985,2,0
Scooter McCray ,1382,36,3,1983,1987,4,0.1
Scot Pollard ,1383,19,11,1997,1998,1,0.9
Scot Pollard ,1383,19,11,1997,1999,2,1.1
Scot Pollard ,1383,19,11,1997,2000,3,5.1
Scot Pollard ,1383,19,11,1997,2001,4,5.4
Scot Pollard ,1383,19,11,1997,2002,5,6.8
Scot Pollard ,1383,19,11,1997,2003,6,1
Scot Pollard ,1383,19,11,1997,2004,7,1.4
Scot Pollard ,1383,19,11,1997,2005,8,1.9
Scot Pollard ,1383,19,11,1997,2006,9,2.1
Scot Pollard ,1383,19,11,1997,2007,10,0.2
Scot Pollard ,1383,19,11,1997,2008,11,0.6
Scott Burrell ,1384,20,8,1993,1994,1,0.5
Scott Burrell ,1384,20,8,1993,1995,2,5.6
Scott Burrell ,1384,20,8,1993,1996,3,1.1
Scott Burrell ,1384,20,8,1993,1997,4,0.8
Scott Burrell ,1384,20,8,1993,1998,5,3.7
Scott Burrell ,1384,20,8,1993,1999,6,1.4
Scott Burrell ,1384,20,8,1993,2000,7,3.2
Scott Burrell ,1384,20,8,1993,2001,8,0.1
Scott Haffner ,1385,45,2,1989,1990,1,-0.1
Scott Haffner ,1385,45,2,1989,1991,2,-0.1
Scott Haskin ,1386,14,1,1993,1994,1,0.3
Scott Hastings ,1387,29,11,1982,1983,1,0.1
Scott Hastings ,1387,29,11,1982,1984,2,2.1
Scott Hastings ,1387,29,11,1982,1985,3,1.3
Scott Hastings ,1387,29,11,1982,1986,4,0.8
Scott Hastings ,1387,29,11,1982,1987,5,0.4
Scott Hastings ,1387,29,11,1982,1988,6,1
Scott Hastings ,1387,29,11,1982,1989,7,1.5
Scott Hastings ,1387,29,11,1982,1990,8,0.3
Scott Hastings ,1387,29,11,1982,1991,9,0.5
Scott Hastings ,1387,29,11,1982,1992,10,0.3
Scott Hastings ,1387,29,11,1982,1993,11,1.3
Scott Padgett ,1388,28,8,1999,2000,1,0.1
Scott Padgett ,1388,28,8,1999,2001,2,0.4
Scott Padgett ,1388,28,8,1999,2002,3,3.5
Scott Padgett ,1388,28,8,1999,2003,4,2.5
Scott Padgett ,1388,28,8,1999,2004,5,1.9
Scott Padgett ,1388,28,8,1999,2005,6,2.8
Scott Padgett ,1388,28,8,1999,2006,7,1.8
Scott Padgett ,1388,28,8,1999,2007,8,0.1
Scott Skiles ,1389,22,10,1986,1987,1,-0.2
Scott Skiles ,1389,22,10,1986,1988,2,0.3
Scott Skiles ,1389,22,10,1986,1989,3,1.3
Scott Skiles ,1389,22,10,1986,1990,4,2
Scott Skiles ,1389,22,10,1986,1991,5,7
Scott Skiles ,1389,22,10,1986,1992,6,3.2
Scott Skiles ,1389,22,10,1986,1993,7,8
Scott Skiles ,1389,22,10,1986,1994,8,4.4
Scott Skiles ,1389,22,10,1986,1995,9,4.5
Scott Skiles ,1389,22,10,1986,1996,10,0.1
Sean Elliott ,1390,3,12,1989,1990,1,4.6
Sean Elliott ,1390,3,12,1989,1991,2,8.8
Sean Elliott ,1390,3,12,1989,1992,3,8.4
Sean Elliott ,1390,3,12,1989,1993,4,6.1
Sean Elliott ,1390,3,12,1989,1994,5,1.4
Sean Elliott ,1390,3,12,1989,1995,6,8.7
Sean Elliott ,1390,3,12,1989,1996,7,7.7
Sean Elliott ,1390,3,12,1989,1997,8,1.5
Sean Elliott ,1390,3,12,1989,1998,9,1.4
Sean Elliott ,1390,3,12,1989,1999,10,3.5
Sean Elliott ,1390,3,12,1989,2000,11,0.5
Sean Elliott ,1390,3,12,1989,2001,12,3
Sean Green ,1391,41,3,1991,1992,1,-0.5
Sean Green ,1391,41,3,1991,1993,2,0
Sean Green ,1391,41,3,1991,1994,3,-0.9
Sean Lampley ,1392,44,2,2001,2003,2,0.9
Sean Lampley ,1392,44,2,2001,2004,3,0.2
Sean Marks ,1393,44,11,1998,1999,1,0
Sean Marks ,1393,44,11,1998,2000,2,0
Sean Marks ,1393,44,11,1998,2002,4,0.3
Sean Marks ,1393,44,11,1998,2003,5,-0.2
Sean Marks ,1393,44,11,1998,2005,7,0.2
Sean Marks ,1393,44,11,1998,2006,8,0.6
Sean Marks ,1393,44,11,1998,2007,9,0
Sean Marks ,1393,44,11,1998,2008,10,0.3
Sean Marks ,1393,44,11,1998,2009,11,1.2
Sean Marks ,1393,44,11,1998,2010,12,0.2
Sean Marks ,1393,44,11,1998,2011,13,0.1
Sean May ,1394,13,4,2005,2006,1,0.4
Sean May ,1394,13,4,2005,2007,2,2.2
Sean May ,1394,13,4,2005,2009,4,-0.3
Sean May ,1394,13,4,2005,2010,5,0.3
Sean Rooks ,1395,30,12,1992,1993,1,1.5
Sean Rooks ,1395,30,12,1992,1994,2,2.2
Sean Rooks ,1395,30,12,1992,1995,3,3
Sean Rooks ,1395,30,12,1992,1996,4,1.8
Sean Rooks ,1395,30,12,1992,1997,5,1.8
Sean Rooks ,1395,30,12,1992,1998,6,1.1
Sean Rooks ,1395,30,12,1992,1999,7,0.3
Sean Rooks ,1395,30,12,1992,2000,8,1.1
Sean Rooks ,1395,30,12,1992,2001,9,2.3
Sean Rooks ,1395,30,12,1992,2002,10,0.6
Sean Rooks ,1395,30,12,1992,2003,11,0.4
Sean Rooks ,1395,30,12,1992,2004,12,0.2
Sean Singletary ,1396,42,1,2008,2009,1,0
Sean Williams ,1397,17,4,2007,2008,1,2.5
Sean Williams ,1397,17,4,2007,2009,2,0.3
Sean Williams ,1397,17,4,2007,2010,3,-0.2
Sean Williams ,1397,17,4,2007,2012,5,0.4
Sebastian Telfair ,1398,13,10,2004,2005,1,-0.4
Sebastian Telfair ,1398,13,10,2004,2006,2,0.6
Sebastian Telfair ,1398,13,10,2004,2007,3,0.5
Sebastian Telfair ,1398,13,10,2004,2008,4,0.7
Sebastian Telfair ,1398,13,10,2004,2009,5,0.8
Sebastian Telfair ,1398,13,10,2004,2010,6,0.3
Sebastian Telfair ,1398,13,10,2004,2011,7,0.1
Sebastian Telfair ,1398,13,10,2004,2012,8,1.1
Sebastian Telfair ,1398,13,10,2004,2013,9,0.8
Sebastian Telfair ,1398,13,10,2004,2015,11,0.4
Serge Ibaka ,1399,24,7,2008,2010,2,3.7
Serge Ibaka ,1399,24,7,2008,2011,3,7.6
Serge Ibaka ,1399,24,7,2008,2012,4,6.2
Serge Ibaka ,1399,24,7,2008,2013,5,9.4
Serge Ibaka ,1399,24,7,2008,2014,6,9.6
Serge Ibaka ,1399,24,7,2008,2015,7,5.6
Serge Ibaka ,1399,24,7,2008,2016,8,5.5
Sergei Monia ,1400,23,1,2004,2006,2,-0.2
Sergey Karasev ,1401,19,3,2013,2014,1,-0.1
Sergey Karasev ,1401,19,3,2013,2015,2,0.7
Sergey Karasev ,1401,19,3,2013,2016,3,0.3
Sergio Rodriguez ,1402,27,4,2006,2007,1,0.9
Sergio Rodriguez ,1402,27,4,2006,2008,2,-0.2
Sergio Rodriguez ,1402,27,4,2006,2009,3,1.7
Sergio Rodriguez ,1402,27,4,2006,2010,4,1.2
Shabazz Muhammad ,1403,14,3,2013,2014,1,0.3
Shabazz Muhammad ,1403,14,3,2013,2015,2,2
Shabazz Muhammad ,1403,14,3,2013,2016,3,2.7
Shabazz Napier ,1404,24,2,2014,2015,1,0.5
Shabazz Napier ,1404,24,2,2014,2016,2,0.1
Shammond Williams ,1405,34,7,1998,1999,1,0
Shammond Williams ,1405,34,7,1998,2000,2,0.2
Shammond Williams ,1405,34,7,1998,2001,3,2.9
Shammond Williams ,1405,34,7,1998,2002,4,1.2
Shammond Williams ,1405,34,7,1998,2003,5,3.1
Shammond Williams ,1405,34,7,1998,2004,6,1
Shammond Williams ,1405,34,7,1998,2007,9,0.5
Shane Battier ,1406,6,13,2001,2002,1,4.8
Shane Battier ,1406,6,13,2001,2003,2,6.2
Shane Battier ,1406,6,13,2001,2004,3,5.9
Shane Battier ,1406,6,13,2001,2005,4,7.8
Shane Battier ,1406,6,13,2001,2006,5,9.1
Shane Battier ,1406,6,13,2001,2007,6,9
Shane Battier ,1406,6,13,2001,2008,7,8.2
Shane Battier ,1406,6,13,2001,2009,8,5.2
Shane Battier ,1406,6,13,2001,2010,9,4.3
Shane Battier ,1406,6,13,2001,2011,10,5.1
Shane Battier ,1406,6,13,2001,2012,11,3.3
Shane Battier ,1406,6,13,2001,2013,12,4.4
Shane Battier ,1406,6,13,2001,2014,13,2.4
Shane Larkin ,1407,18,3,2013,2014,1,-0.1
Shane Larkin ,1407,18,3,2013,2015,2,1.7
Shane Larkin ,1407,18,3,2013,2016,3,1.4
Shannon Brown ,1408,25,9,2006,2007,1,0.1
Shannon Brown ,1408,25,9,2006,2008,2,-0.5
Shannon Brown ,1408,25,9,2006,2009,3,0.7
Shannon Brown ,1408,25,9,2006,2010,4,3.4
Shannon Brown ,1408,25,9,2006,2011,5,3.1
Shannon Brown ,1408,25,9,2006,2012,6,1.6
Shannon Brown ,1408,25,9,2006,2013,7,1.2
Shannon Brown ,1408,25,9,2006,2014,8,-0.3
Shannon Brown ,1408,25,9,2006,2015,9,0
Shaquille O'Neal ,1409,1,19,1992,1993,1,10.4
Shaquille O'Neal ,1409,1,19,1992,1994,2,16.9
Shaquille O'Neal ,1409,1,19,1992,1995,3,14
Shaquille O'Neal ,1409,1,19,1992,1996,4,6.9
Shaquille O'Neal ,1409,1,19,1992,1998,6,10.2
Shaquille O'Neal ,1409,1,19,1992,1999,7,9
Shaquille O'Neal ,1409,1,19,1992,2000,8,18.6
Shaquille O'Neal ,1409,1,19,1992,2001,9,14.9
Shaquille O'Neal ,1409,1,19,1992,2002,10,13.2
Shaquille O'Neal ,1409,1,19,1992,2003,11,13.2
Shaquille O'Neal ,1409,1,19,1992,2004,12,9.9
Shaquille O'Neal ,1409,1,19,1992,2005,13,11
Shaquille O'Neal ,1409,1,19,1992,2006,14,6.2
Shaquille O'Neal ,1409,1,19,1992,2009,17,7.8
Shaquille O'Neal ,1409,1,19,1992,2010,18,3.1
Shaquille O'Neal ,1409,1,19,1992,2011,19,2.7
Shareef Abdur-Rahim ,1410,3,12,1996,1997,1,2.9
Shareef Abdur-Rahim ,1410,3,12,1996,1998,2,6.9
Shareef Abdur-Rahim ,1410,3,12,1996,1999,3,4.6
Shareef Abdur-Rahim ,1410,3,12,1996,2000,4,8.8
Shareef Abdur-Rahim ,1410,3,12,1996,2001,5,8.5
Shareef Abdur-Rahim ,1410,3,12,1996,2002,6,7.2
Shareef Abdur-Rahim ,1410,3,12,1996,2003,7,9.7
Shareef Abdur-Rahim ,1410,3,12,1996,2004,8,8.1
Shareef Abdur-Rahim ,1410,3,12,1996,2005,9,5.4
Shareef Abdur-Rahim ,1410,3,12,1996,2006,10,6.2
Shareef Abdur-Rahim ,1410,3,12,1996,2007,11,2.8
Shareef Abdur-Rahim ,1410,3,12,1996,2008,12,0
Sharone Wright ,1411,6,4,1994,1995,1,1.7
Sharone Wright ,1411,6,4,1994,1996,2,1.3
Sharone Wright ,1411,6,4,1994,1997,3,-1.6
Sharone Wright ,1411,6,4,1994,1998,4,0
Shaun Livingston ,1412,4,11,2004,2005,1,0.1
Shaun Livingston ,1412,4,11,2004,2006,2,1.3
Shaun Livingston ,1412,4,11,2004,2007,3,2.4
Shaun Livingston ,1412,4,11,2004,2009,5,0.4
Shaun Livingston ,1412,4,11,2004,2010,6,1.2
Shaun Livingston ,1412,4,11,2004,2011,7,1.9
Shaun Livingston ,1412,4,11,2004,2012,8,1.3
Shaun Livingston ,1412,4,11,2004,2013,9,2.6
Shaun Livingston ,1412,4,11,2004,2014,10,4.4
Shaun Livingston ,1412,4,11,2004,2015,11,3.3
Shaun Livingston ,1412,4,11,2004,2016,12,4.6
Shawn Bradley ,1413,2,12,1993,1994,1,-1.1
Shawn Bradley ,1413,2,12,1993,1995,2,3.5
Shawn Bradley ,1413,2,12,1993,1996,3,3
Shawn Bradley ,1413,2,12,1993,1997,4,3
Shawn Bradley ,1413,2,12,1993,1998,5,2.9
Shawn Bradley ,1413,2,12,1993,1999,6,4.2
Shawn Bradley ,1413,2,12,1993,2000,7,5.1
Shawn Bradley ,1413,2,12,1993,2001,8,6.3
Shawn Bradley ,1413,2,12,1993,2002,9,2.3
Shawn Bradley ,1413,2,12,1993,2003,10,7.4
Shawn Bradley ,1413,2,12,1993,2004,11,2.3
Shawn Bradley ,1413,2,12,1993,2005,12,1.9
Shawn Kemp ,1414,17,14,1989,1990,1,2.1
Shawn Kemp ,1414,17,14,1989,1991,2,6.1
Shawn Kemp ,1414,17,14,1989,1992,3,6.7
Shawn Kemp ,1414,17,14,1989,1993,4,9.1
Shawn Kemp ,1414,17,14,1989,1994,5,11.7
Shawn Kemp ,1414,17,14,1989,1995,6,10.6
Shawn Kemp ,1414,17,14,1989,1996,7,11.2
Shawn Kemp ,1414,17,14,1989,1997,8,10
Shawn Kemp ,1414,17,14,1989,1998,9,6.8
Shawn Kemp ,1414,17,14,1989,1999,10,6.3
Shawn Kemp ,1414,17,14,1989,2000,11,4
Shawn Kemp ,1414,17,14,1989,2001,12,0.9
Shawn Kemp ,1414,17,14,1989,2002,13,1.9
Shawn Kemp ,1414,17,14,1989,2003,14,2
Shawn Marion ,1415,9,16,1999,2000,1,4.1
Shawn Marion ,1415,9,16,1999,2001,2,11.7
Shawn Marion ,1415,9,16,1999,2002,3,9.8
Shawn Marion ,1415,9,16,1999,2003,4,13
Shawn Marion ,1415,9,16,1999,2004,5,9.1
Shawn Marion ,1415,9,16,1999,2005,6,12.5
Shawn Marion ,1415,9,16,1999,2006,7,14.6
Shawn Marion ,1415,9,16,1999,2007,8,12
Shawn Marion ,1415,9,16,1999,2008,9,7.4
Shawn Marion ,1415,9,16,1999,2009,10,5.2
Shawn Marion ,1415,9,16,1999,2010,11,5
Shawn Marion ,1415,9,16,1999,2011,12,5.6
Shawn Marion ,1415,9,16,1999,2012,13,3.7
Shawn Marion ,1415,9,16,1999,2013,14,5.3
Shawn Marion ,1415,9,16,1999,2014,15,4.3
Shawn Marion ,1415,9,16,1999,2015,16,1.7
Shawn Respert ,1416,8,4,1995,1996,1,0.5
Shawn Respert ,1416,8,4,1995,1997,2,0.7
Shawn Respert ,1416,8,4,1995,1998,3,0.8
Shawn Respert ,1416,8,4,1995,1999,4,0.1
Shawne Williams ,1417,17,7,2006,2007,1,0.7
Shawne Williams ,1417,17,7,2006,2008,2,1.4
Shawne Williams ,1417,17,7,2006,2009,3,0
Shawne Williams ,1417,17,7,2006,2011,5,2.5
Shawne Williams ,1417,17,7,2006,2012,6,-0.4
Shawne Williams ,1417,17,7,2006,2014,8,0.7
Shawne Williams ,1417,17,7,2006,2015,9,1.9
Shawnelle Scott ,1418,43,4,1994,1997,3,0.2
Shawnelle Scott ,1418,43,4,1994,1998,4,0.5
Shawnelle Scott ,1418,43,4,1994,2001,7,0.2
Shawnelle Scott ,1418,43,4,1994,2002,8,0.4
Shelden Williams ,1419,5,6,2006,2007,1,2.2
Shelden Williams ,1419,5,6,2006,2008,2,1.2
Shelden Williams ,1419,5,6,2006,2009,3,0.5
Shelden Williams ,1419,5,6,2006,2010,4,2
Shelden Williams ,1419,5,6,2006,2011,5,1.9
Shelden Williams ,1419,5,6,2006,2012,6,2.1
Shelton Jones ,1420,27,1,1988,1989,1,0.3
Shelvin Mack ,1421,34,5,2011,2012,1,0.7
Shelvin Mack ,1421,34,5,2011,2013,2,0.5
Shelvin Mack ,1421,34,5,2011,2014,3,2.3
Shelvin Mack ,1421,34,5,2011,2015,4,1.3
Shelvin Mack ,1421,34,5,2011,2016,5,1.3
Sherell Ford ,1422,26,1,1995,1996,1,0.4
Sherman Douglas ,1423,28,12,1989,1990,1,4.4
Sherman Douglas ,1423,28,12,1989,1991,2,5.4
Sherman Douglas ,1423,28,12,1989,1992,3,1
Sherman Douglas ,1423,28,12,1989,1993,4,2.6
Sherman Douglas ,1423,28,12,1989,1994,5,2.7
Sherman Douglas ,1423,28,12,1989,1995,6,4.2
Sherman Douglas ,1423,28,12,1989,1996,7,3.3
Sherman Douglas ,1423,28,12,1989,1997,8,4.6
Sherman Douglas ,1423,28,12,1989,1998,9,4
Sherman Douglas ,1423,28,12,1989,1999,10,-0.1
Sherman Douglas ,1423,28,12,1989,2000,11,0.6
Sherman Douglas ,1423,28,12,1989,2001,12,0.2
Sidney Green ,1424,5,10,1983,1984,1,0.3
Sidney Green ,1424,5,10,1983,1985,2,0.6
Sidney Green ,1424,5,10,1983,1986,3,2.5
Sidney Green ,1424,5,10,1983,1987,4,3.4
Sidney Green ,1424,5,10,1983,1988,5,2.7
Sidney Green ,1424,5,10,1983,1989,6,2
Sidney Green ,1424,5,10,1983,1990,7,1.7
Sidney Green ,1424,5,10,1983,1991,8,1.9
Sidney Green ,1424,5,10,1983,1992,9,1.9
Sidney Green ,1424,5,10,1983,1993,10,0.4
Sidney Lowe ,1425,25,4,1983,1984,1,1.7
Sidney Lowe ,1425,25,4,1983,1985,2,0.3
Sidney Lowe ,1425,25,4,1983,1989,6,0.5
Sidney Lowe ,1425,25,4,1983,1990,7,1.5
Sidney Moncrief ,1426,5,11,1979,1980,1,4.9
Sidney Moncrief ,1426,5,11,1979,1981,2,9.9
Sidney Moncrief ,1426,5,11,1979,1982,3,13.4
Sidney Moncrief ,1426,5,11,1979,1983,4,13.2
Sidney Moncrief ,1426,5,11,1979,1984,5,12.7
Sidney Moncrief ,1426,5,11,1979,1985,6,11.2
Sidney Moncrief ,1426,5,11,1979,1986,7,11.7
Sidney Moncrief ,1426,5,11,1979,1987,8,2.9
Sidney Moncrief ,1426,5,11,1979,1988,9,3.7
Sidney Moncrief ,1426,5,11,1979,1989,10,5
Sidney Moncrief ,1426,5,11,1979,1991,12,1.8
Slavko Vranes ,1427,39,1,2003,2004,1,0
Sleepy Floyd ,1428,13,13,1982,1983,1,2.2
Sleepy Floyd ,1428,13,13,1982,1984,2,4.4
Sleepy Floyd ,1428,13,13,1982,1985,3,3.1
Sleepy Floyd ,1428,13,13,1982,1986,4,7.5
Sleepy Floyd ,1428,13,13,1982,1987,5,10
Sleepy Floyd ,1428,13,13,1982,1988,6,4.4
Sleepy Floyd ,1428,13,13,1982,1989,7,7.7
Sleepy Floyd ,1428,13,13,1982,1990,8,6.3
Sleepy Floyd ,1428,13,13,1982,1991,9,3.7
Sleepy Floyd ,1428,13,13,1982,1992,10,0.9
Sleepy Floyd ,1428,13,13,1982,1993,11,1
Sleepy Floyd ,1428,13,13,1982,1994,12,-0.4
Sleepy Floyd ,1428,13,13,1982,1995,13,-0.2
Sly Williams ,1429,21,7,1979,1980,1,-0.1
Sly Williams ,1429,21,7,1979,1981,2,5.1
Sly Williams ,1429,21,7,1979,1982,3,4.2
Sly Williams ,1429,21,7,1979,1983,4,3.8
Sly Williams ,1429,21,7,1979,1984,5,-0.1
Sly Williams ,1429,21,7,1979,1985,6,0.5
Sly Williams ,1429,21,7,1979,1986,7,-0.2
Solomon Alabi ,1430,50,2,2010,2011,1,-0.2
Solomon Alabi ,1430,50,2,2010,2012,2,0.2
Solomon Hill ,1431,23,3,2013,2014,1,0.4
Solomon Hill ,1431,23,3,2013,2015,2,3.5
Solomon Hill ,1431,23,3,2013,2016,3,2.1
Solomon Jones ,1432,33,8,2006,2007,1,1.6
Solomon Jones ,1432,33,8,2006,2008,2,0
Solomon Jones ,1432,33,8,2006,2009,3,1.9
Solomon Jones ,1432,33,8,2006,2010,4,0.8
Solomon Jones ,1432,33,8,2006,2011,5,0.5
Solomon Jones ,1432,33,8,2006,2012,6,0.3
Solomon Jones ,1432,33,8,2006,2013,7,-0.1
Solomon Jones ,1432,33,8,2006,2014,8,0
Sonny Weems ,1433,39,4,2008,2009,1,-0.3
Sonny Weems ,1433,39,4,2008,2010,2,1.3
Sonny Weems ,1433,39,4,2008,2011,3,-0.4
Sonny Weems ,1433,39,4,2008,2016,8,-0.5
Soumaila Samake ,1434,36,2,2000,2001,1,0.1
Soumaila Samake ,1434,36,2,2000,2003,3,0.2
Speedy Claxton ,1435,20,7,2000,2002,2,2.8
Speedy Claxton ,1435,20,7,2000,2003,3,1.2
Speedy Claxton ,1435,20,7,2000,2004,4,4.2
Speedy Claxton ,1435,20,7,2000,2005,5,3.7
Speedy Claxton ,1435,20,7,2000,2006,6,3
Speedy Claxton ,1435,20,7,2000,2007,7,-0.7
Speedy Claxton ,1435,20,7,2000,2009,9,0
Spencer Dinwiddie ,1436,38,2,2014,2015,1,0.1
Spencer Dinwiddie ,1436,38,2,2014,2016,2,0.1
Spencer Hawes ,1437,10,9,2007,2008,1,0.6
Spencer Hawes ,1437,10,9,2007,2009,2,0.8
Spencer Hawes ,1437,10,9,2007,2010,3,2.1
Spencer Hawes ,1437,10,9,2007,2011,4,2.4
Spencer Hawes ,1437,10,9,2007,2012,5,2.9
Spencer Hawes ,1437,10,9,2007,2013,6,4.5
Spencer Hawes ,1437,10,9,2007,2014,7,4.5
Spencer Hawes ,1437,10,9,2007,2015,8,1.2
Spencer Hawes ,1437,10,9,2007,2016,9,1.9
Stacey Augmon ,1438,9,15,1991,1992,1,3.7
Stacey Augmon ,1438,9,15,1991,1993,2,3.7
Stacey Augmon ,1438,9,15,1991,1994,3,9.7
Stacey Augmon ,1438,9,15,1991,1995,4,5.1
Stacey Augmon ,1438,9,15,1991,1996,5,5.6
Stacey Augmon ,1438,9,15,1991,1997,6,1.5
Stacey Augmon ,1438,9,15,1991,1998,7,1.8
Stacey Augmon ,1438,9,15,1991,1999,8,2.6
Stacey Augmon ,1438,9,15,1991,2000,9,1.5
Stacey Augmon ,1438,9,15,1991,2001,10,2.5
Stacey Augmon ,1438,9,15,1991,2002,11,2.3
Stacey Augmon ,1438,9,15,1991,2003,12,1.2
Stacey Augmon ,1438,9,15,1991,2004,13,1.6
Stacey Augmon ,1438,9,15,1991,2005,14,0.7
Stacey Augmon ,1438,9,15,1991,2006,15,0.3
Stacey King ,1439,6,8,1989,1990,1,3.6
Stacey King ,1439,6,8,1989,1991,2,1.5
Stacey King ,1439,6,8,1989,1992,3,3.1
Stacey King ,1439,6,8,1989,1993,4,1.9
Stacey King ,1439,6,8,1989,1994,5,0.9
Stacey King ,1439,6,8,1989,1995,6,0.1
Stacey King ,1439,6,8,1989,1996,7,-0.2
Stacey King ,1439,6,8,1989,1997,8,0
Stanley Brundy ,1440,32,1,1989,1990,1,0.2
Stanley Johnson ,1441,8,1,2015,2016,1,0.6
Stanley Roberts ,1442,23,8,1991,1992,1,2.1
Stanley Roberts ,1442,23,8,1991,1993,2,3.2
Stanley Roberts ,1442,23,8,1991,1994,3,-0.1
Stanley Roberts ,1442,23,8,1991,1996,5,0.7
Stanley Roberts ,1442,23,8,1991,1997,6,0.5
Stanley Roberts ,1442,23,8,1991,1998,7,1.8
Stanley Roberts ,1442,23,8,1991,1999,8,-0.1
Stanley Roberts ,1442,23,8,1991,2000,9,0
Stephane Lasme ,1443,46,1,2007,2008,1,0.3
Stephen Curry ,1444,7,7,2009,2010,1,4.7
Stephen Curry ,1444,7,7,2009,2011,2,6.6
Stephen Curry ,1444,7,7,2009,2012,3,2.2
Stephen Curry ,1444,7,7,2009,2013,4,11.2
Stephen Curry ,1444,7,7,2009,2014,5,13.4
Stephen Curry ,1444,7,7,2009,2015,6,15.7
Stephen Curry ,1444,7,7,2009,2016,7,17.9
Stephen Jackson ,1445,42,14,1997,2001,4,0.9
Stephen Jackson ,1445,42,14,1997,2002,5,-0.1
Stephen Jackson ,1445,42,14,1997,2003,6,4.8
Stephen Jackson ,1445,42,14,1997,2004,7,4.4
Stephen Jackson ,1445,42,14,1997,2005,8,3.1
Stephen Jackson ,1445,42,14,1997,2006,9,4.4
Stephen Jackson ,1445,42,14,1997,2007,10,4.1
Stephen Jackson ,1445,42,14,1997,2008,11,4.6
Stephen Jackson ,1445,42,14,1997,2009,12,2.2
Stephen Jackson ,1445,42,14,1997,2010,13,5
Stephen Jackson ,1445,42,14,1997,2011,14,1.9
Stephen Jackson ,1445,42,14,1997,2012,15,0.6
Stephen Jackson ,1445,42,14,1997,2013,16,0.3
Stephen Jackson ,1445,42,14,1997,2014,17,-0.2
Stephon Marbury ,1446,4,13,1996,1997,1,3.7
Stephon Marbury ,1446,4,13,1996,1998,2,5.3
Stephon Marbury ,1446,4,13,1996,1999,3,5.3
Stephon Marbury ,1446,4,13,1996,2000,4,7.4
Stephon Marbury ,1446,4,13,1996,2001,5,7.8
Stephon Marbury ,1446,4,13,1996,2002,6,7.1
Stephon Marbury ,1446,4,13,1996,2003,7,9.6
Stephon Marbury ,1446,4,13,1996,2004,8,9.1
Stephon Marbury ,1446,4,13,1996,2005,9,11.7
Stephon Marbury ,1446,4,13,1996,2006,10,3.9
Stephon Marbury ,1446,4,13,1996,2007,11,5.9
Stephon Marbury ,1446,4,13,1996,2008,12,1.1
Stephon Marbury ,1446,4,13,1996,2009,13,-0.3
Steve Alford ,1447,26,4,1987,1988,1,0.3
Steve Alford ,1447,26,4,1987,1989,2,1.4
Steve Alford ,1447,26,4,1987,1990,3,0.9
Steve Alford ,1447,26,4,1987,1991,4,0.6
Steve Bardo ,1448,41,3,1990,1992,2,0
Steve Bardo ,1448,41,3,1990,1993,3,-0.3
Steve Bardo ,1448,41,3,1990,1996,6,0.2
Steve Blake ,1449,38,13,2003,2004,1,0.7
Steve Blake ,1449,38,13,2003,2005,2,0.3
Steve Blake ,1449,38,13,2003,2006,3,2.8
Steve Blake ,1449,38,13,2003,2007,4,2.1
Steve Blake ,1449,38,13,2003,2008,5,3.8
Steve Blake ,1449,38,13,2003,2009,6,5.8
Steve Blake ,1449,38,13,2003,2010,7,3.3
Steve Blake ,1449,38,13,2003,2011,8,1.8
Steve Blake ,1449,38,13,2003,2012,9,1
Steve Blake ,1449,38,13,2003,2013,10,2.4
Steve Blake ,1449,38,13,2003,2014,11,1.8
Steve Blake ,1449,38,13,2003,2015,12,2.1
Steve Blake ,1449,38,13,2003,2016,13,1.1
Steve Burtt ,1450,30,4,1984,1985,1,-0.4
Steve Burtt ,1450,30,4,1984,1988,4,-0.1
Steve Burtt ,1450,30,4,1984,1992,8,0.5
Steve Burtt ,1450,30,4,1984,1993,9,0
Steve Colter ,1451,33,8,1984,1985,1,2.3
Steve Colter ,1451,33,8,1984,1986,2,3.3
Steve Colter ,1451,33,8,1984,1987,3,1.7
Steve Colter ,1451,33,8,1984,1988,4,2.6
Steve Colter ,1451,33,8,1984,1989,5,3.1
Steve Colter ,1451,33,8,1984,1990,6,2.7
Steve Colter ,1451,33,8,1984,1991,7,0.3
Steve Colter ,1451,33,8,1984,1995,11,1.4
Steve Francis ,1452,2,9,1999,2000,1,6.4
Steve Francis ,1452,2,9,1999,2001,2,12.2
Steve Francis ,1452,2,9,1999,2002,3,4.4
Steve Francis ,1452,2,9,1999,2003,4,11.1
Steve Francis ,1452,2,9,1999,2004,5,7.1
Steve Francis ,1452,2,9,1999,2005,6,6.2
Steve Francis ,1452,2,9,1999,2006,7,3.6
Steve Francis ,1452,2,9,1999,2007,8,2.9
Steve Francis ,1452,2,9,1999,2008,9,0.2
Steve Hamer ,1453,38,1,1996,1997,1,0.2
Steve Harris ,1454,19,5,1985,1986,1,0.8
Steve Harris ,1454,19,5,1985,1987,2,1.3
Steve Harris ,1454,19,5,1985,1988,3,1.2
Steve Harris ,1454,19,5,1985,1989,4,0
Steve Harris ,1454,19,5,1985,1990,5,-0.1
Steve Henson ,1455,44,7,1990,1991,1,1.2
Steve Henson ,1455,44,7,1990,1992,2,0.2
Steve Henson ,1455,44,7,1990,1993,3,1.1
Steve Henson ,1455,44,7,1990,1994,4,0
Steve Henson ,1455,44,7,1990,1995,5,1
Steve Henson ,1455,44,7,1990,1998,8,0.1
Steve Henson ,1455,44,7,1990,1999,9,0
Steve Johnson ,1456,7,10,1981,1982,1,4.4
Steve Johnson ,1456,7,10,1981,1983,2,4.4
Steve Johnson ,1456,7,10,1981,1984,3,2.4
Steve Johnson ,1456,7,10,1981,1985,4,3.1
Steve Johnson ,1456,7,10,1981,1986,5,4.9
Steve Johnson ,1456,7,10,1981,1987,6,4.4
Steve Johnson ,1456,7,10,1981,1988,7,1.3
Steve Johnson ,1456,7,10,1981,1989,8,1.7
Steve Johnson ,1456,7,10,1981,1990,9,0
Steve Johnson ,1456,7,10,1981,1991,10,0.2
Steve Kerr ,1457,50,15,1988,1989,1,0.4
Steve Kerr ,1457,50,15,1988,1990,2,3.2
Steve Kerr ,1457,50,15,1988,1991,3,1.3
Steve Kerr ,1457,50,15,1988,1992,4,2.4
Steve Kerr ,1457,50,15,1988,1993,5,0.6
Steve Kerr ,1457,50,15,1988,1994,6,6.1
Steve Kerr ,1457,50,15,1988,1995,7,5.9
Steve Kerr ,1457,50,15,1988,1996,8,8.3
Steve Kerr ,1457,50,15,1988,1997,9,7.5
Steve Kerr ,1457,50,15,1988,1998,10,3.8
Steve Kerr ,1457,50,15,1988,1999,11,1.6
Steve Kerr ,1457,50,15,1988,2000,12,0.6
Steve Kerr ,1457,50,15,1988,2001,13,1.5
Steve Kerr ,1457,50,15,1988,2002,14,1.8
Steve Kerr ,1457,50,15,1988,2003,15,2.2
Steve Lingenfelter ,1458,44,2,1981,1983,2,0
Steve Lingenfelter ,1458,44,2,1981,1984,3,0
Steve Nash ,1459,15,18,1996,1997,1,0.7
Steve Nash ,1459,15,18,1996,1998,2,4.8
Steve Nash ,1459,15,18,1996,1999,3,1
Steve Nash ,1459,15,18,1996,2000,4,3
Steve Nash ,1459,15,18,1996,2001,5,8.4
Steve Nash ,1459,15,18,1996,2002,6,9.9
Steve Nash ,1459,15,18,1996,2003,7,11.6
Steve Nash ,1459,15,18,1996,2004,8,8.8
Steve Nash ,1459,15,18,1996,2005,9,10.9
Steve Nash ,1459,15,18,1996,2006,10,12.4
Steve Nash ,1459,15,18,1996,2007,11,12.6
Steve Nash ,1459,15,18,1996,2008,12,10.5
Steve Nash ,1459,15,18,1996,2009,13,7.3
Steve Nash ,1459,15,18,1996,2010,14,9.9
Steve Nash ,1459,15,18,1996,2011,15,7.9
Steve Nash ,1459,15,18,1996,2012,16,5.9
Steve Nash ,1459,15,18,1996,2013,17,4.3
Steve Nash ,1459,15,18,1996,2014,18,0.1
Steve Novak ,1460,32,10,2006,2007,1,0.4
Steve Novak ,1460,32,10,2006,2008,2,1.1
Steve Novak ,1460,32,10,2006,2009,3,2.2
Steve Novak ,1460,32,10,2006,2010,4,0.3
Steve Novak ,1460,32,10,2006,2011,5,0.9
Steve Novak ,1460,32,10,2006,2012,6,3.9
Steve Novak ,1460,32,10,2006,2013,7,4
Steve Novak ,1460,32,10,2006,2014,8,1.4
Steve Novak ,1460,32,10,2006,2015,9,0.3
Steve Novak ,1460,32,10,2006,2016,10,0.1
Steve Scheffler ,1461,39,7,1990,1991,1,0.6
Steve Scheffler ,1461,39,7,1990,1992,2,0.3
Steve Scheffler ,1461,39,7,1990,1993,3,0.6
Steve Scheffler ,1461,39,7,1990,1994,4,0.7
Steve Scheffler ,1461,39,7,1990,1995,5,0.4
Steve Scheffler ,1461,39,7,1990,1996,6,0.4
Steve Scheffler ,1461,39,7,1990,1997,7,0
Steve Smith ,1462,5,14,1991,1992,1,1.5
Steve Smith ,1462,5,14,1991,1993,2,3.5
Steve Smith ,1462,5,14,1991,1994,3,8.1
Steve Smith ,1462,5,14,1991,1995,4,7.8
Steve Smith ,1462,5,14,1991,1996,5,7.9
Steve Smith ,1462,5,14,1991,1997,6,9.1
Steve Smith ,1462,5,14,1991,1998,7,10.2
Steve Smith ,1462,5,14,1991,1999,8,4.4
Steve Smith ,1462,5,14,1991,2000,9,10.4
Steve Smith ,1462,5,14,1991,2001,10,8.2
Steve Smith ,1462,5,14,1991,2002,11,6.4
Steve Smith ,1462,5,14,1991,2003,12,2.5
Steve Smith ,1462,5,14,1991,2004,13,1.9
Steve Smith ,1462,5,14,1991,2005,14,1.8
Steve Stipanovich ,1463,2,5,1983,1984,1,3.6
Steve Stipanovich ,1463,2,5,1983,1985,2,5
Steve Stipanovich ,1463,2,5,1983,1986,3,5.9
Steve Stipanovich ,1463,2,5,1983,1987,4,9
Steve Stipanovich ,1463,2,5,1983,1988,5,6.9
Steven Adams ,1464,12,3,2013,2014,1,2.9
Steven Adams ,1464,12,3,2013,2015,2,4.1
Steven Adams ,1464,12,3,2013,2016,3,6.5
Steven Hunter ,1465,15,8,2001,2002,1,1
Steven Hunter ,1465,15,8,2001,2003,2,0.9
Steven Hunter ,1465,15,8,2001,2004,3,0.6
Steven Hunter ,1465,15,8,2001,2005,4,2.6
Steven Hunter ,1465,15,8,2001,2006,5,2.5
Steven Hunter ,1465,15,8,2001,2007,6,2.8
Steven Hunter ,1465,15,8,2001,2008,7,0.1
Steven Hunter ,1465,15,8,2001,2010,9,0.1
Stewart Granger ,1466,24,3,1983,1984,1,0.5
Stewart Granger ,1466,24,3,1983,1985,2,-0.2
Stewart Granger ,1466,24,3,1983,1987,4,-0.4
Stromile Swift ,1467,2,9,2000,2001,1,1.9
Stromile Swift ,1467,2,9,2000,2002,2,3.7
Stromile Swift ,1467,2,9,2000,2003,3,3.3
Stromile Swift ,1467,2,9,2000,2004,4,4.8
Stromile Swift ,1467,2,9,2000,2005,5,2.9
Stromile Swift ,1467,2,9,2000,2006,6,2.5
Stromile Swift ,1467,2,9,2000,2007,7,1
Stromile Swift ,1467,2,9,2000,2008,8,1.4
Stromile Swift ,1467,2,9,2000,2009,9,-0.1
Stuart Gray ,1468,29,7,1984,1985,1,-0.4
Stuart Gray ,1468,29,7,1984,1986,2,0.7
Stuart Gray ,1468,29,7,1984,1987,3,0.4
Stuart Gray ,1468,29,7,1984,1988,4,1.1
Stuart Gray ,1468,29,7,1984,1989,5,0.9
Stuart Gray ,1468,29,7,1984,1990,6,0.6
Stuart Gray ,1468,29,7,1984,1991,7,0
Sun Yue ,1469,40,1,2007,2009,2,-0.1
Sylvester Gray ,1470,35,1,1988,1989,1,0.7
T.J. Ford ,1471,8,8,2003,2004,1,0.7
T.J. Ford ,1471,8,8,2003,2006,3,2.5
T.J. Ford ,1471,8,8,2003,2007,4,4.3
T.J. Ford ,1471,8,8,2003,2008,5,3.3
T.J. Ford ,1471,8,8,2003,2009,6,4.3
T.J. Ford ,1471,8,8,2003,2010,7,1.4
T.J. Ford ,1471,8,8,2003,2011,8,0.2
T.J. Ford ,1471,8,8,2003,2012,9,0.2
T.J. Warren ,1472,14,2,2014,2015,1,1.1
T.J. Warren ,1472,14,2,2014,2016,2,2.2
Taj Gibson ,1473,26,7,2009,2010,1,4.7
Taj Gibson ,1473,26,7,2009,2011,2,5.2
Taj Gibson ,1473,26,7,2009,2012,3,4.5
Taj Gibson ,1473,26,7,2009,2013,4,3.3
Taj Gibson ,1473,26,7,2009,2014,5,5.7
Taj Gibson ,1473,26,7,2009,2015,6,4.8
Taj Gibson ,1473,26,7,2009,2016,7,5.4
Tariq Abdul-Wahad ,1474,11,6,1997,1998,1,-0.2
Tariq Abdul-Wahad ,1474,11,6,1997,1999,2,1.4
Tariq Abdul-Wahad ,1474,11,6,1997,2000,3,2.2
Tariq Abdul-Wahad ,1474,11,6,1997,2001,4,-0.4
Tariq Abdul-Wahad ,1474,11,6,1997,2002,5,0
Tariq Abdul-Wahad ,1474,11,6,1997,2003,6,0.4
Tate George ,1475,22,4,1990,1991,1,0.4
Tate George ,1475,22,4,1990,1992,2,1.1
Tate George ,1475,22,4,1990,1993,3,-0.1
Tate George ,1475,22,4,1990,1995,5,0
Taylor Griffin ,1476,48,1,2009,2010,1,0
Tayshaun Prince ,1477,23,14,2002,2003,1,0.8
Tayshaun Prince ,1477,23,14,2002,2004,2,7.5
Tayshaun Prince ,1477,23,14,2002,2005,3,9.4
Tayshaun Prince ,1477,23,14,2002,2006,4,7
Tayshaun Prince ,1477,23,14,2002,2007,5,8
Tayshaun Prince ,1477,23,14,2002,2008,6,7.5
Tayshaun Prince ,1477,23,14,2002,2009,7,6.2
Tayshaun Prince ,1477,23,14,2002,2010,8,3.2
Tayshaun Prince ,1477,23,14,2002,2011,9,3.3
Tayshaun Prince ,1477,23,14,2002,2012,10,2.1
Tayshaun Prince ,1477,23,14,2002,2013,11,3.6
Tayshaun Prince ,1477,23,14,2002,2014,12,1.5
Tayshaun Prince ,1477,23,14,2002,2015,13,2.5
Tayshaun Prince ,1477,23,14,2002,2016,14,0.4
Tellis Frank ,1478,14,5,1987,1988,1,0.6
Tellis Frank ,1478,14,5,1987,1989,2,0.1
Tellis Frank ,1478,14,5,1987,1990,3,2
Tellis Frank ,1478,14,5,1987,1992,5,0.3
Tellis Frank ,1478,14,5,1987,1994,7,1.1
Terence Morris ,1479,33,3,2001,2002,1,0.2
Terence Morris ,1479,33,3,2001,2003,2,0.9
Terence Morris ,1479,33,3,2001,2006,5,-0.1
Terence Stansbury ,1480,15,3,1984,1985,1,1.5
Terence Stansbury ,1480,15,3,1984,1986,2,0.6
Terence Stansbury ,1480,15,3,1984,1987,3,0.3
Terrell Brandon ,1481,11,11,1991,1992,1,0.9
Terrell Brandon ,1481,11,11,1991,1993,2,3.9
Terrell Brandon ,1481,11,11,1991,1994,3,2.9
Terrell Brandon ,1481,11,11,1991,1995,4,5.6
Terrell Brandon ,1481,11,11,1991,1996,5,12.7
Terrell Brandon ,1481,11,11,1991,1997,6,10.8
Terrell Brandon ,1481,11,11,1991,1998,7,5.1
Terrell Brandon ,1481,11,11,1991,1999,8,3.2
Terrell Brandon ,1481,11,11,1991,2000,9,8.6
Terrell Brandon ,1481,11,11,1991,2001,10,8.5
Terrell Brandon ,1481,11,11,1991,2002,11,3.7
Terrence Jones ,1482,18,4,2012,2013,1,0.7
Terrence Jones ,1482,18,4,2012,2014,2,7.3
Terrence Jones ,1482,18,4,2012,2015,3,3
Terrence Jones ,1482,18,4,2012,2016,4,1.5
Terrence Rencher ,1483,32,1,1995,1996,1,-0.2
Terrence Ross ,1484,8,4,2012,2013,1,0.9
Terrence Ross ,1484,8,4,2012,2014,2,4.2
Terrence Ross ,1484,8,4,2012,2015,3,2.4
Terrence Ross ,1484,8,4,2012,2016,4,3.6
Terrence Williams ,1485,11,4,2009,2010,1,-0.3
Terrence Williams ,1485,11,4,2009,2011,2,-0.6
Terrence Williams ,1485,11,4,2009,2012,3,0.3
Terrence Williams ,1485,11,4,2009,2013,4,0.3
Terry Catledge ,1486,21,8,1985,1986,1,1.7
Terry Catledge ,1486,21,8,1985,1987,2,3.6
Terry Catledge ,1486,21,8,1985,1988,3,3.5
Terry Catledge ,1486,21,8,1985,1989,4,3.3
Terry Catledge ,1486,21,8,1985,1990,5,2.5
Terry Catledge ,1486,21,8,1985,1991,6,1.6
Terry Catledge ,1486,21,8,1985,1992,7,4.6
Terry Catledge ,1486,21,8,1985,1993,8,0.1
Terry Cummings ,1487,2,18,1982,1983,1,8.7
Terry Cummings ,1487,2,18,1982,1984,2,7.5
Terry Cummings ,1487,2,18,1982,1985,3,10.7
Terry Cummings ,1487,2,18,1982,1986,4,7.4
Terry Cummings ,1487,2,18,1982,1987,5,8.8
Terry Cummings ,1487,2,18,1982,1988,6,5.2
Terry Cummings ,1487,2,18,1982,1989,7,7.7
Terry Cummings ,1487,2,18,1982,1990,8,8.7
Terry Cummings ,1487,2,18,1982,1991,9,5.6
Terry Cummings ,1487,2,18,1982,1992,10,6.5
Terry Cummings ,1487,2,18,1982,1993,11,0
Terry Cummings ,1487,2,18,1982,1994,12,1.8
Terry Cummings ,1487,2,18,1982,1995,13,2
Terry Cummings ,1487,2,18,1982,1996,14,3
Terry Cummings ,1487,2,18,1982,1997,15,2.1
Terry Cummings ,1487,2,18,1982,1998,16,2.6
Terry Cummings ,1487,2,18,1982,1999,17,2.6
Terry Cummings ,1487,2,18,1982,2000,18,0.4
Terry Dehere ,1488,13,6,1993,1994,1,-0.4
Terry Dehere ,1488,13,6,1993,1995,2,0.5
Terry Dehere ,1488,13,6,1993,1996,3,5
Terry Dehere ,1488,13,6,1993,1997,4,1.2
Terry Dehere ,1488,13,6,1993,1998,5,1
Terry Dehere ,1488,13,6,1993,1999,6,0
Terry Duerod ,1489,48,4,1979,1980,1,0.7
Terry Duerod ,1489,48,4,1979,1981,2,0.2
Terry Duerod ,1489,48,4,1979,1982,3,0.2
Terry Duerod ,1489,48,4,1979,1983,4,-0.2
Terry Mills ,1490,16,11,1990,1991,1,1.3
Terry Mills ,1490,16,11,1990,1992,2,3.9
Terry Mills ,1490,16,11,1990,1993,3,3.8
Terry Mills ,1490,16,11,1990,1994,4,6.3
Terry Mills ,1490,16,11,1990,1995,5,3.7
Terry Mills ,1490,16,11,1990,1996,6,3.7
Terry Mills ,1490,16,11,1990,1997,7,6.2
Terry Mills ,1490,16,11,1990,1998,8,0.9
Terry Mills ,1490,16,11,1990,1999,9,0
Terry Mills ,1490,16,11,1990,2000,10,3.8
Terry Mills ,1490,16,11,1990,2001,11,-0.2
Terry Porter ,1491,24,17,1985,1986,1,2.3
Terry Porter ,1491,24,17,1985,1987,2,6.8
Terry Porter ,1491,24,17,1985,1988,3,9.8
Terry Porter ,1491,24,17,1985,1989,4,9.2
Terry Porter ,1491,24,17,1985,1990,5,11.7
Terry Porter ,1491,24,17,1985,1991,6,13
Terry Porter ,1491,24,17,1985,1992,7,10.6
Terry Porter ,1491,24,17,1985,1993,8,8.8
Terry Porter ,1491,24,17,1985,1994,9,5.4
Terry Porter ,1491,24,17,1985,1995,10,1.7
Terry Porter ,1491,24,17,1985,1996,11,3.7
Terry Porter ,1491,24,17,1985,1997,12,2.7
Terry Porter ,1491,24,17,1985,1998,13,5.2
Terry Porter ,1491,24,17,1985,1999,14,5
Terry Porter ,1491,24,17,1985,2000,15,5.6
Terry Porter ,1491,24,17,1985,2001,16,5.4
Terry Porter ,1491,24,17,1985,2002,17,3.5
Terry Rozier ,1492,16,1,2015,2016,1,-0.3
Terry Teagle ,1493,16,11,1982,1983,1,-0.8
Terry Teagle ,1493,16,11,1982,1984,2,0.2
Terry Teagle ,1493,16,11,1982,1985,3,0.7
Terry Teagle ,1493,16,11,1982,1986,4,3.1
Terry Teagle ,1493,16,11,1982,1987,5,1.3
Terry Teagle ,1493,16,11,1982,1988,6,-0.2
Terry Teagle ,1493,16,11,1982,1989,7,3.1
Terry Teagle ,1493,16,11,1982,1990,8,2.7
Terry Teagle ,1493,16,11,1982,1991,9,2.1
Terry Teagle ,1493,16,11,1982,1992,10,1.3
Terry Teagle ,1493,16,11,1982,1993,11,0
Terry Tyler ,1494,23,11,1978,1979,1,5.4
Terry Tyler ,1494,23,11,1978,1980,2,3.4
Terry Tyler ,1494,23,11,1978,1981,3,6.4
Terry Tyler ,1494,23,11,1978,1982,4,5.5
Terry Tyler ,1494,23,11,1978,1983,5,5.8
Terry Tyler ,1494,23,11,1978,1984,6,2.5
Terry Tyler ,1494,23,11,1978,1985,7,4.5
Terry Tyler ,1494,23,11,1978,1986,8,1.9
Terry Tyler ,1494,23,11,1978,1987,9,2.9
Terry Tyler ,1494,23,11,1978,1988,10,1.2
Terry Tyler ,1494,23,11,1978,1989,11,1.2
Thabo Sefolosha ,1495,13,10,2006,2007,1,0.8
Thabo Sefolosha ,1495,13,10,2006,2008,2,1.5
Thabo Sefolosha ,1495,13,10,2006,2009,3,2.2
Thabo Sefolosha ,1495,13,10,2006,2010,4,4
Thabo Sefolosha ,1495,13,10,2006,2011,5,4.1
Thabo Sefolosha ,1495,13,10,2006,2012,6,1.8
Thabo Sefolosha ,1495,13,10,2006,2013,7,6.8
Thabo Sefolosha ,1495,13,10,2006,2014,8,3
Thabo Sefolosha ,1495,13,10,2006,2015,9,2.5
Thabo Sefolosha ,1495,13,10,2006,2016,10,4.5
Thaddeus Young ,1496,12,9,2007,2008,1,4.5
Thaddeus Young ,1496,12,9,2007,2009,2,5.5
Thaddeus Young ,1496,12,9,2007,2010,3,2.1
Thaddeus Young ,1496,12,9,2007,2011,4,6.2
Thaddeus Young ,1496,12,9,2007,2012,5,6.3
Thaddeus Young ,1496,12,9,2007,2013,6,7.4
Thaddeus Young ,1496,12,9,2007,2014,7,3.5
Thaddeus Young ,1496,12,9,2007,2015,8,3.1
Thaddeus Young ,1496,12,9,2007,2016,9,4.1
Theo Ratliff ,1497,18,16,1995,1996,1,3.8
Theo Ratliff ,1497,18,16,1995,1997,2,3.9
Theo Ratliff ,1497,18,16,1995,1998,3,6.7
Theo Ratliff ,1497,18,16,1995,1999,4,5.4
Theo Ratliff ,1497,18,16,1995,2000,5,5.6
Theo Ratliff ,1497,18,16,1995,2001,6,5.2
Theo Ratliff ,1497,18,16,1995,2002,7,0
Theo Ratliff ,1497,18,16,1995,2003,8,4
Theo Ratliff ,1497,18,16,1995,2004,9,5.2
Theo Ratliff ,1497,18,16,1995,2005,10,2.3
Theo Ratliff ,1497,18,16,1995,2006,11,2
Theo Ratliff ,1497,18,16,1995,2007,12,0.1
Theo Ratliff ,1497,18,16,1995,2008,13,0.8
Theo Ratliff ,1497,18,16,1995,2009,14,1.4
Theo Ratliff ,1497,18,16,1995,2010,15,1.4
Theo Ratliff ,1497,18,16,1995,2011,16,0
Thomas Robinson ,1498,5,4,2012,2013,1,-0.1
Thomas Robinson ,1498,5,4,2012,2014,2,1.6
Thomas Robinson ,1498,5,4,2012,2015,3,1.5
Thomas Robinson ,1498,5,4,2012,2016,4,0.6
Thurl Bailey ,1499,7,12,1983,1984,1,3.6
Thurl Bailey ,1499,7,12,1983,1985,2,5.4
Thurl Bailey ,1499,7,12,1983,1986,3,4
Thurl Bailey ,1499,7,12,1983,1987,4,3.1
Thurl Bailey ,1499,7,12,1983,1988,5,6.8
Thurl Bailey ,1499,7,12,1983,1989,6,6.5
Thurl Bailey ,1499,7,12,1983,1990,7,4.6
Thurl Bailey ,1499,7,12,1983,1991,8,3.7
Thurl Bailey ,1499,7,12,1983,1992,9,2.6
Thurl Bailey ,1499,7,12,1983,1993,10,1.2
Thurl Bailey ,1499,7,12,1983,1994,11,2.6
Thurl Bailey ,1499,7,12,1983,1999,16,0.9
Tiago Splitter ,1500,28,6,2007,2011,4,2.3
Tiago Splitter ,1500,28,6,2007,2012,5,4.6
Tiago Splitter ,1500,28,6,2007,2013,6,8.2
Tiago Splitter ,1500,28,6,2007,2014,7,4.3
Tiago Splitter ,1500,28,6,2007,2015,8,4
Tiago Splitter ,1500,28,6,2007,2016,9,1.7
Tibor Pleiss ,1501,31,1,2010,2016,6,-0.1
Tim Duncan ,1502,1,19,1997,1998,1,12.8
Tim Duncan ,1502,1,19,1997,1999,2,8.7
Tim Duncan ,1502,1,19,1997,2000,3,13
Tim Duncan ,1502,1,19,1997,2001,4,13.2
Tim Duncan ,1502,1,19,1997,2002,5,17.8
Tim Duncan ,1502,1,19,1997,2003,6,16.5
Tim Duncan ,1502,1,19,1997,2004,7,13.1
Tim Duncan ,1502,1,19,1997,2005,8,11.2
Tim Duncan ,1502,1,19,1997,2006,9,10.8
Tim Duncan ,1502,1,19,1997,2007,10,13
Tim Duncan ,1502,1,19,1997,2008,11,11.1
Tim Duncan ,1502,1,19,1997,2009,12,10.1
Tim Duncan ,1502,1,19,1997,2010,13,10.9
Tim Duncan ,1502,1,19,1997,2011,14,7.7
Tim Duncan ,1502,1,19,1997,2012,15,5.9
Tim Duncan ,1502,1,19,1997,2013,16,8.3
Tim Duncan ,1502,1,19,1997,2014,17,7.4
Tim Duncan ,1502,1,19,1997,2015,18,9.6
Tim Duncan ,1502,1,19,1997,2016,19,5.2
Tim Hardaway ,1503,14,13,1989,1990,1,3.3
Tim Hardaway ,1503,14,13,1989,1991,2,9.9
Tim Hardaway ,1503,14,13,1989,1992,3,9.2
Tim Hardaway ,1503,14,13,1989,1993,4,7.5
Tim Hardaway ,1503,14,13,1989,1995,6,5.1
Tim Hardaway ,1503,14,13,1989,1996,7,7.3
Tim Hardaway ,1503,14,13,1989,1997,8,12.9
Tim Hardaway ,1503,14,13,1989,1998,9,11.7
Tim Hardaway ,1503,14,13,1989,1999,10,5.4
Tim Hardaway ,1503,14,13,1989,2000,11,4.3
Tim Hardaway ,1503,14,13,1989,2001,12,6.4
Tim Hardaway ,1503,14,13,1989,2002,13,1.8
Tim Hardaway ,1503,14,13,1989,2003,14,0.2
Tim Hardaway ,1503,14,13,1989,2014,25,3.1
Tim Hardaway ,1503,14,13,1989,2015,26,0.8
Tim Hardaway ,1503,14,13,1989,2016,27,1.9
Tim Hardaway Jr,1504,24,3,2013,2014,1,3.1
Tim Hardaway Jr,1504,24,3,2013,2015,2,0.8
Tim Hardaway Jr,1504,24,3,2013,2016,3,1.9
Tim James ,1505,25,3,1999,2000,1,-0.1
Tim James ,1505,25,3,1999,2001,2,0.1
Tim James ,1505,25,3,1999,2002,3,-0.1
Tim McCormick ,1506,12,8,1984,1985,1,3.8
Tim McCormick ,1506,12,8,1984,1986,2,4.6
Tim McCormick ,1506,12,8,1984,1987,3,6
Tim McCormick ,1506,12,8,1984,1988,4,3.9
Tim McCormick ,1506,12,8,1984,1989,5,2
Tim McCormick ,1506,12,8,1984,1990,6,-0.1
Tim McCormick ,1506,12,8,1984,1991,7,1.1
Tim McCormick ,1506,12,8,1984,1992,8,0.2
Tim Perry ,1507,7,8,1988,1989,1,1.4
Tim Perry ,1507,7,8,1988,1990,2,1.2
Tim Perry ,1507,7,8,1988,1991,3,1.4
Tim Perry ,1507,7,8,1988,1992,4,5.7
Tim Perry ,1507,7,8,1988,1993,5,2
Tim Perry ,1507,7,8,1988,1994,6,2.6
Tim Perry ,1507,7,8,1988,1995,7,-0.1
Tim Perry ,1507,7,8,1988,1996,8,0.3
Tim Thomas ,1508,7,13,1997,1998,1,3.4
Tim Thomas ,1508,7,13,1997,1999,2,2.2
Tim Thomas ,1508,7,13,1997,2000,3,3.8
Tim Thomas ,1508,7,13,1997,2001,4,5.5
Tim Thomas ,1508,7,13,1997,2002,5,2.2
Tim Thomas ,1508,7,13,1997,2003,6,2.9
Tim Thomas ,1508,7,13,1997,2004,7,4.1
Tim Thomas ,1508,7,13,1997,2005,8,2.2
Tim Thomas ,1508,7,13,1997,2006,9,0.9
Tim Thomas ,1508,7,13,1997,2007,10,3.9
Tim Thomas ,1508,7,13,1997,2008,11,1.7
Tim Thomas ,1508,7,13,1997,2009,12,1.7
Tim Thomas ,1508,7,13,1997,2010,13,0.7
Tito Horford ,1509,39,3,1988,1989,1,-0.3
Tito Horford ,1509,39,3,1988,1990,2,-0.2
Tito Horford ,1509,39,3,1988,1994,6,0
Tito Maddox ,1510,37,1,2002,2003,1,0
Tobias Harris ,1511,19,5,2011,2012,1,0.9
Tobias Harris ,1511,19,5,2011,2013,2,2.4
Tobias Harris ,1511,19,5,2011,2014,3,4.1
Tobias Harris ,1511,19,5,2011,2015,4,4.8
Tobias Harris ,1511,19,5,2011,2016,5,6.6
Toby Bailey ,1512,45,2,1998,1999,1,0.2
Toby Bailey ,1512,45,2,1998,2000,2,0.8
Todd Day ,1513,8,8,1992,1993,1,2.6
Todd Day ,1513,8,8,1992,1994,2,2.1
Todd Day ,1513,8,8,1992,1995,3,4.8
Todd Day ,1513,8,8,1992,1996,4,1.9
Todd Day ,1513,8,8,1992,1997,5,3.2
Todd Day ,1513,8,8,1992,1998,6,0.1
Todd Day ,1513,8,8,1992,2000,8,2.5
Todd Day ,1513,8,8,1992,2001,9,0.3
Todd Fuller ,1514,11,5,1996,1997,1,0.7
Todd Fuller ,1514,11,5,1996,1998,2,0.7
Todd Fuller ,1514,11,5,1996,1999,3,0.6
Todd Fuller ,1514,11,5,1996,2000,4,0.2
Todd Fuller ,1514,11,5,1996,2001,5,0
Todd Lichti ,1515,15,5,1989,1990,1,1.8
Todd Lichti ,1515,15,5,1989,1991,2,1
Todd Lichti ,1515,15,5,1989,1992,3,1.3
Todd Lichti ,1515,15,5,1989,1993,4,1.2
Todd Lichti ,1515,15,5,1989,1994,5,0.2
Todd MacCulloch ,1516,47,4,1999,2000,1,1.7
Todd MacCulloch ,1516,47,4,1999,2001,2,2.5
Todd MacCulloch ,1516,47,4,1999,2002,3,5.6
Todd MacCulloch ,1516,47,4,1999,2003,4,2.2
Todd Mitchell ,1517,43,1,1988,1989,1,-0.1
Tom Chambers ,1518,8,16,1981,1982,1,3.3
Tom Chambers ,1518,8,16,1981,1983,2,4.3
Tom Chambers ,1518,8,16,1981,1984,3,6.1
Tom Chambers ,1518,8,16,1981,1985,4,5.9
Tom Chambers ,1518,8,16,1981,1986,5,4.8
Tom Chambers ,1518,8,16,1981,1987,6,7.4
Tom Chambers ,1518,8,16,1981,1988,7,6.4
Tom Chambers ,1518,8,16,1981,1989,8,9.2
Tom Chambers ,1518,8,16,1981,1990,9,11.2
Tom Chambers ,1518,8,16,1981,1991,10,5.4
Tom Chambers ,1518,8,16,1981,1992,11,4.4
Tom Chambers ,1518,8,16,1981,1993,12,4.5
Tom Chambers ,1518,8,16,1981,1994,13,3.9
Tom Chambers ,1518,8,16,1981,1995,14,2.5
Tom Chambers ,1518,8,16,1981,1997,16,-0.4
Tom Chambers ,1518,8,16,1981,1998,17,0.1
Tom Garrick ,1519,45,4,1988,1989,1,1.4
Tom Garrick ,1519,45,4,1988,1990,2,2.5
Tom Garrick ,1519,45,4,1988,1991,3,1.8
Tom Garrick ,1519,45,4,1988,1992,4,0.2
Tom Gugliotta ,1520,6,13,1992,1993,1,1.6
Tom Gugliotta ,1520,6,13,1992,1994,2,3.8
Tom Gugliotta ,1520,6,13,1992,1995,3,3.5
Tom Gugliotta ,1520,6,13,1992,1996,4,5.3
Tom Gugliotta ,1520,6,13,1992,1997,5,6.7
Tom Gugliotta ,1520,6,13,1992,1998,6,5
Tom Gugliotta ,1520,6,13,1992,1999,7,5.4
Tom Gugliotta ,1520,6,13,1992,2000,8,5.2
Tom Gugliotta ,1520,6,13,1992,2001,9,1.8
Tom Gugliotta ,1520,6,13,1992,2002,10,0.9
Tom Gugliotta ,1520,6,13,1992,2003,11,0.4
Tom Gugliotta ,1520,6,13,1992,2004,12,0.3
Tom Gugliotta ,1520,6,13,1992,2005,13,0.4
Tom Hammonds ,1521,9,12,1989,1990,1,0.5
Tom Hammonds ,1521,9,12,1989,1991,2,0.8
Tom Hammonds ,1521,9,12,1989,1992,3,0.6
Tom Hammonds ,1521,9,12,1989,1993,4,0.8
Tom Hammonds ,1521,9,12,1989,1994,5,2.2
Tom Hammonds ,1521,9,12,1989,1995,6,2.6
Tom Hammonds ,1521,9,12,1989,1996,7,1.8
Tom Hammonds ,1521,9,12,1989,1997,8,1.7
Tom Hammonds ,1521,9,12,1989,1998,9,2.4
Tom Hammonds ,1521,9,12,1989,1999,10,1
Tom Hammonds ,1521,9,12,1989,2000,11,0.5
Tom Hammonds ,1521,9,12,1989,2001,12,-0.1
Tom Sewell ,1522,22,1,1984,1985,1,-0.4
Tom Sluby ,1523,41,1,1984,1985,1,0.2
Tom Tolbert ,1524,34,7,1988,1989,1,0.1
Tom Tolbert ,1524,34,7,1988,1990,2,2.5
Tom Tolbert ,1524,34,7,1988,1991,3,1.3
Tom Tolbert ,1524,34,7,1988,1992,4,0
Tom Tolbert ,1524,34,7,1988,1993,5,2.7
Tom Tolbert ,1524,34,7,1988,1994,6,0
Tom Tolbert ,1524,34,7,1988,1995,7,0
Tommie Green ,1525,35,1,1978,1979,1,-0.3
Toney Douglas ,1526,29,7,2009,2010,1,2.2
Toney Douglas ,1526,29,7,2009,2011,2,4.2
Toney Douglas ,1526,29,7,2009,2012,3,-0.6
Toney Douglas ,1526,29,7,2009,2013,4,2.4
Toney Douglas ,1526,29,7,2009,2014,5,0.9
Toney Douglas ,1526,29,7,2009,2015,6,0.2
Toney Douglas ,1526,29,7,2009,2016,7,2.5
Toni Kukoc ,1527,29,13,1990,1994,4,3.2
Toni Kukoc ,1527,29,13,1990,1995,5,10
Toni Kukoc ,1527,29,13,1990,1996,6,10.1
Toni Kukoc ,1527,29,13,1990,1997,7,6.9
Toni Kukoc ,1527,29,13,1990,1998,8,7
Toni Kukoc ,1527,29,13,1990,1999,9,2.8
Toni Kukoc ,1527,29,13,1990,2000,10,3.4
Toni Kukoc ,1527,29,13,1990,2001,11,4.7
Toni Kukoc ,1527,29,13,1990,2002,12,2
Toni Kukoc ,1527,29,13,1990,2003,13,4
Toni Kukoc ,1527,29,13,1990,2004,14,3.1
Toni Kukoc ,1527,29,13,1990,2005,15,1.5
Toni Kukoc ,1527,29,13,1990,2006,16,1.1
Tony Allen ,1528,25,12,2004,2005,1,2.7
Tony Allen ,1528,25,12,2004,2006,2,1.7
Tony Allen ,1528,25,12,2004,2007,3,1.9
Tony Allen ,1528,25,12,2004,2008,4,2.7
Tony Allen ,1528,25,12,2004,2009,5,1.6
Tony Allen ,1528,25,12,2004,2010,6,1.9
Tony Allen ,1528,25,12,2004,2011,7,4.7
Tony Allen ,1528,25,12,2004,2012,8,4.2
Tony Allen ,1528,25,12,2004,2013,9,5.1
Tony Allen ,1528,25,12,2004,2014,10,2.7
Tony Allen ,1528,25,12,2004,2015,11,4.1
Tony Allen ,1528,25,12,2004,2016,12,2.4
Tony Battie ,1529,5,14,1997,1998,1,0.5
Tony Battie ,1529,5,14,1997,1999,2,3.3
Tony Battie ,1529,5,14,1997,2000,3,3.8
Tony Battie ,1529,5,14,1997,2001,4,2.3
Tony Battie ,1529,5,14,1997,2002,5,6.2
Tony Battie ,1529,5,14,1997,2003,6,5.8
Tony Battie ,1529,5,14,1997,2004,7,2.3
Tony Battie ,1529,5,14,1997,2005,8,2
Tony Battie ,1529,5,14,1997,2006,9,3.8
Tony Battie ,1529,5,14,1997,2007,10,2.7
Tony Battie ,1529,5,14,1997,2009,12,2.8
Tony Battie ,1529,5,14,1997,2010,13,0
Tony Battie ,1529,5,14,1997,2011,14,0.6
Tony Battie ,1529,5,14,1997,2012,15,0.5
Tony Bennett ,1530,35,3,1992,1993,1,0.7
Tony Bennett ,1530,35,3,1992,1994,2,0.9
Tony Bennett ,1530,35,3,1992,1995,3,0
Tony Campbell ,1531,20,11,1984,1985,1,0.4
Tony Campbell ,1531,20,11,1984,1986,2,1.4
Tony Campbell ,1531,20,11,1984,1987,3,-0.3
Tony Campbell ,1531,20,11,1984,1988,4,0.4
Tony Campbell ,1531,20,11,1984,1989,5,1.1
Tony Campbell ,1531,20,11,1984,1990,6,5.3
Tony Campbell ,1531,20,11,1984,1991,7,3.7
Tony Campbell ,1531,20,11,1984,1992,8,2.5
Tony Campbell ,1531,20,11,1984,1993,9,2.5
Tony Campbell ,1531,20,11,1984,1994,10,1.5
Tony Campbell ,1531,20,11,1984,1995,11,2.1
Tony Delk ,1532,16,10,1996,1997,1,1.6
Tony Delk ,1532,16,10,1996,1998,2,0.8
Tony Delk ,1532,16,10,1996,1999,3,0.4
Tony Delk ,1532,16,10,1996,2000,4,1.3
Tony Delk ,1532,16,10,1996,2001,5,4.6
Tony Delk ,1532,16,10,1996,2002,6,2.5
Tony Delk ,1532,16,10,1996,2003,7,4.6
Tony Delk ,1532,16,10,1996,2004,8,0.8
Tony Delk ,1532,16,10,1996,2005,9,2.1
Tony Delk ,1532,16,10,1996,2006,10,0.9
Tony Dumas ,1533,19,4,1994,1995,1,0
Tony Dumas ,1533,19,4,1994,1996,2,1.6
Tony Dumas ,1533,19,4,1994,1997,3,-0.3
Tony Dumas ,1533,19,4,1994,1998,4,0
Tony Massenburg ,1534,43,13,1990,1991,1,0.4
Tony Massenburg ,1534,43,13,1990,1992,2,-0.1
Tony Massenburg ,1534,43,13,1990,1995,5,2.2
Tony Massenburg ,1534,43,13,1990,1996,6,1.7
Tony Massenburg ,1534,43,13,1990,1997,7,2.8
Tony Massenburg ,1534,43,13,1990,1998,8,1.3
Tony Massenburg ,1534,43,13,1990,1999,9,1.8
Tony Massenburg ,1534,43,13,1990,2000,10,0.2
Tony Massenburg ,1534,43,13,1990,2001,11,0.7
Tony Massenburg ,1534,43,13,1990,2002,12,1.5
Tony Massenburg ,1534,43,13,1990,2003,13,1
Tony Massenburg ,1534,43,13,1990,2004,14,0.9
Tony Massenburg ,1534,43,13,1990,2005,15,1.1
Tony Mitchell ,1535,37,1,2013,2014,1,0.1
Tony Parker ,1536,28,15,2001,2002,1,3.8
Tony Parker ,1536,28,15,2001,2003,2,7.7
Tony Parker ,1536,28,15,2001,2004,3,7.5
Tony Parker ,1536,28,15,2001,2005,4,8.1
Tony Parker ,1536,28,15,2001,2006,5,9.6
Tony Parker ,1536,28,15,2001,2007,6,9.6
Tony Parker ,1536,28,15,2001,2008,7,7
Tony Parker ,1536,28,15,2001,2009,8,8.6
Tony Parker ,1536,28,15,2001,2010,9,3.6
Tony Parker ,1536,28,15,2001,2011,10,8.2
Tony Parker ,1536,28,15,2001,2012,11,7.1
Tony Parker ,1536,28,15,2001,2013,12,9.3
Tony Parker ,1536,28,15,2001,2014,13,5.9
Tony Parker ,1536,28,15,2001,2015,14,4.1
Tony Parker ,1536,28,15,2001,2016,15,5.8
Tony Price ,1537,29,1,1979,1981,2,-0.1
Tony Snell ,1538,20,3,2013,2014,1,1.6
Tony Snell ,1538,20,3,2013,2015,2,2.4
Tony Snell ,1538,20,3,2013,2016,3,0.4
Tony White ,1539,33,1,1987,1988,1,-0.3
Tony Wroten ,1540,25,4,2012,2013,1,0.1
Tony Wroten ,1540,25,4,2012,2014,2,-0.9
Tony Wroten ,1540,25,4,2012,2015,3,0.3
Tony Wroten ,1540,25,4,2012,2016,4,-0.8
Tony Zeno ,1541,32,1,1979,1980,1,-0.2
Tracy Jackson ,1542,25,3,1981,1982,1,0.7
Tracy Jackson ,1542,25,3,1981,1983,2,1.7
Tracy Jackson ,1542,25,3,1981,1984,3,0
Tracy McGrady ,1543,9,15,1997,1998,1,2
Tracy McGrady ,1543,9,15,1997,1999,2,3.3
Tracy McGrady ,1543,9,15,1997,2000,3,6.6
Tracy McGrady ,1543,9,15,1997,2001,4,12.2
Tracy McGrady ,1543,9,15,1997,2002,5,11.5
Tracy McGrady ,1543,9,15,1997,2003,6,16.1
Tracy McGrady ,1543,9,15,1997,2004,7,8.4
Tracy McGrady ,1543,9,15,1997,2005,8,12
Tracy McGrady ,1543,9,15,1997,2006,9,4.1
Tracy McGrady ,1543,9,15,1997,2007,10,8.6
Tracy McGrady ,1543,9,15,1997,2008,11,5.8
Tracy McGrady ,1543,9,15,1997,2009,12,2.7
Tracy McGrady ,1543,9,15,1997,2010,13,0.3
Tracy McGrady ,1543,9,15,1997,2011,14,2.1
Tracy McGrady ,1543,9,15,1997,2012,15,1.6
Tracy Murray ,1544,18,12,1992,1993,1,0.5
Tracy Murray ,1544,18,12,1992,1994,2,2.2
Tracy Murray ,1544,18,12,1992,1995,3,0.5
Tracy Murray ,1544,18,12,1992,1996,4,4.9
Tracy Murray ,1544,18,12,1992,1997,5,4.4
Tracy Murray ,1544,18,12,1992,1998,6,6.5
Tracy Murray ,1544,18,12,1992,1999,7,0.3
Tracy Murray ,1544,18,12,1992,2000,8,3.8
Tracy Murray ,1544,18,12,1992,2001,9,0.6
Tracy Murray ,1544,18,12,1992,2002,10,0.8
Tracy Murray ,1544,18,12,1992,2003,11,-0.2
Tracy Murray ,1544,18,12,1992,2004,12,-0.1
Trajan Langdon ,1545,11,3,1999,2000,1,0.3
Trajan Langdon ,1545,11,3,1999,2001,2,2
Trajan Langdon ,1545,11,3,1999,2002,3,0.6
Travis Best ,1546,23,10,1995,1996,1,0.7
Travis Best ,1546,23,10,1995,1997,2,4.1
Travis Best ,1546,23,10,1995,1998,3,3.3
Travis Best ,1546,23,10,1995,1999,4,2.1
Travis Best ,1546,23,10,1995,2000,5,5.1
Travis Best ,1546,23,10,1995,2001,6,7.2
Travis Best ,1546,23,10,1995,2002,7,3.4
Travis Best ,1546,23,10,1995,2003,8,1.8
Travis Best ,1546,23,10,1995,2004,9,0.7
Travis Best ,1546,23,10,1995,2005,10,2.5
Travis Diener ,1547,38,5,2005,2006,1,0.6
Travis Diener ,1547,38,5,2005,2007,2,0.7
Travis Diener ,1547,38,5,2005,2008,3,2.5
Travis Diener ,1547,38,5,2005,2009,4,1.9
Travis Diener ,1547,38,5,2005,2010,5,0
Travis Hansen ,1548,37,1,2003,2004,1,0.2
Travis Knight ,1549,29,7,1996,1997,1,3.3
Travis Knight ,1549,29,7,1996,1998,2,3
Travis Knight ,1549,29,7,1996,1999,3,1.1
Travis Knight ,1549,29,7,1996,2000,4,0.6
Travis Knight ,1549,29,7,1996,2001,5,-0.3
Travis Knight ,1549,29,7,1996,2002,6,-0.1
Travis Knight ,1549,29,7,1996,2003,7,0.2
Travis Leslie ,1550,47,1,2011,2012,1,0.1
Travis Mays ,1551,14,3,1990,1991,1,2.1
Travis Mays ,1551,14,3,1990,1992,2,0
Travis Mays ,1551,14,3,1990,1993,3,0.3
Travis Outlaw ,1552,23,11,2003,2004,1,0
Travis Outlaw ,1552,23,11,2003,2005,2,1.4
Travis Outlaw ,1552,23,11,2003,2006,3,0.9
Travis Outlaw ,1552,23,11,2003,2007,4,2.3
Travis Outlaw ,1552,23,11,2003,2008,5,3.2
Travis Outlaw ,1552,23,11,2003,2009,6,5.3
Travis Outlaw ,1552,23,11,2003,2010,7,0.9
Travis Outlaw ,1552,23,11,2003,2011,8,0.8
Travis Outlaw ,1552,23,11,2003,2012,9,-0.1
Travis Outlaw ,1552,23,11,2003,2013,10,0.3
Travis Outlaw ,1552,23,11,2003,2014,11,1.4
Trent Tucker ,1553,6,11,1982,1983,1,4
Trent Tucker ,1553,6,11,1982,1984,2,3
Trent Tucker ,1553,6,11,1982,1985,3,3.3
Trent Tucker ,1553,6,11,1982,1986,4,4
Trent Tucker ,1553,6,11,1982,1987,5,3.4
Trent Tucker ,1553,6,11,1982,1988,6,2.9
Trent Tucker ,1553,6,11,1982,1989,7,4.6
Trent Tucker ,1553,6,11,1982,1990,8,3.3
Trent Tucker ,1553,6,11,1982,1991,9,1.9
Trent Tucker ,1553,6,11,1982,1992,10,1.1
Trent Tucker ,1553,6,11,1982,1993,11,2.8
Trenton Hassell ,1554,29,9,2001,2002,1,1.5
Trenton Hassell ,1554,29,9,2001,2003,2,-0.1
Trenton Hassell ,1554,29,9,2001,2004,3,4
Trenton Hassell ,1554,29,9,2001,2005,4,2.7
Trenton Hassell ,1554,29,9,2001,2006,5,2.3
Trenton Hassell ,1554,29,9,2001,2007,6,2.6
Trenton Hassell ,1554,29,9,2001,2008,7,0.2
Trenton Hassell ,1554,29,9,2001,2009,8,0.7
Trenton Hassell ,1554,29,9,2001,2010,9,-0.1
Trevor Ariza ,1555,43,12,2004,2005,1,2.1
Trevor Ariza ,1555,43,12,2004,2006,2,0.9
Trevor Ariza ,1555,43,12,2004,2007,3,3.4
Trevor Ariza ,1555,43,12,2004,2008,4,1.8
Trevor Ariza ,1555,43,12,2004,2009,5,6.1
Trevor Ariza ,1555,43,12,2004,2010,6,3.2
Trevor Ariza ,1555,43,12,2004,2011,7,3.4
Trevor Ariza ,1555,43,12,2004,2012,8,2.2
Trevor Ariza ,1555,43,12,2004,2013,9,3.1
Trevor Ariza ,1555,43,12,2004,2014,10,8
Trevor Ariza ,1555,43,12,2004,2015,11,6.6
Trevor Ariza ,1555,43,12,2004,2016,12,5.4
Trevor Booker ,1556,23,6,2010,2011,1,2.6
Trevor Booker ,1556,23,6,2010,2012,2,3
Trevor Booker ,1556,23,6,2010,2013,3,2.3
Trevor Booker ,1556,23,6,2010,2014,4,4.3
Trevor Booker ,1556,23,6,2010,2015,5,3.6
Trevor Booker ,1556,23,6,2010,2016,6,4.3
Trevor Wilson ,1557,36,4,1990,1991,1,-0.5
Trevor Wilson ,1557,36,4,1990,1994,4,0.8
Trevor Wilson ,1557,36,4,1990,1995,5,0.3
Trevor Wilson ,1557,36,4,1990,1996,6,0.2
Trey Burke ,1558,9,3,2013,2014,1,0.9
Trey Burke ,1558,9,3,2013,2015,2,2.4
Trey Burke ,1558,9,3,2013,2016,3,2.1
Trey Lyles ,1559,12,1,2015,2016,1,2.3
Trey Thompkins ,1560,37,1,2011,2012,1,0
Tristan Thompson ,1561,4,5,2011,2012,1,1.1
Tristan Thompson ,1561,4,5,2011,2013,2,5.2
Tristan Thompson ,1561,4,5,2011,2014,3,5.7
Tristan Thompson ,1561,4,5,2011,2015,4,6.8
Tristan Thompson ,1561,4,5,2011,2016,5,8.7
Troy Bell ,1562,16,1,2003,2004,1,-0.2
Troy Murphy ,1563,14,12,2001,2002,1,1.4
Troy Murphy ,1563,14,12,2001,2003,2,6.4
Troy Murphy ,1563,14,12,2001,2004,3,1.3
Troy Murphy ,1563,14,12,2001,2005,4,5.3
Troy Murphy ,1563,14,12,2001,2006,5,6.5
Troy Murphy ,1563,14,12,2001,2007,6,4.5
Troy Murphy ,1563,14,12,2001,2008,7,6.2
Troy Murphy ,1563,14,12,2001,2009,8,8.5
Troy Murphy ,1563,14,12,2001,2010,9,7.8
Troy Murphy ,1563,14,12,2001,2011,10,0.3
Troy Murphy ,1563,14,12,2001,2012,11,1.7
Troy Murphy ,1563,14,12,2001,2013,12,0.3
Ty Lawson ,1564,18,7,2009,2010,1,3.7
Ty Lawson ,1564,18,7,2009,2011,2,6.7
Ty Lawson ,1564,18,7,2009,2012,3,6.9
Ty Lawson ,1564,18,7,2009,2013,4,7.4
Ty Lawson ,1564,18,7,2009,2014,5,6.3
Ty Lawson ,1564,18,7,2009,2015,6,7
Ty Lawson ,1564,18,7,2009,2016,7,0.9
Tyler Ennis ,1565,18,2,2014,2015,1,-0.3
Tyler Ennis ,1565,18,2,2014,2016,2,0.4
Tyler Hansbrough ,1566,13,7,2009,2010,1,0.7
Tyler Hansbrough ,1566,13,7,2009,2011,2,3.8
Tyler Hansbrough ,1566,13,7,2009,2012,3,3.9
Tyler Hansbrough ,1566,13,7,2009,2013,4,4.4
Tyler Hansbrough ,1566,13,7,2009,2014,5,3
Tyler Hansbrough ,1566,13,7,2009,2015,6,3.4
Tyler Hansbrough ,1566,13,7,2009,2016,7,1
Tyler Honeycutt ,1567,35,2,2011,2012,1,0
Tyler Honeycutt ,1567,35,2,2011,2013,2,-0.1
Tyler Zeller ,1568,17,4,2012,2013,1,2
Tyler Zeller ,1568,17,4,2012,2014,2,2.6
Tyler Zeller ,1568,17,4,2012,2015,3,6.5
Tyler Zeller ,1568,17,4,2012,2016,4,1.7
Tyreke Evans ,1569,4,7,2009,2010,1,5.4
Tyreke Evans ,1569,4,7,2009,2011,2,1.6
Tyreke Evans ,1569,4,7,2009,2012,3,2.7
Tyreke Evans ,1569,4,7,2009,2013,4,4.4
Tyreke Evans ,1569,4,7,2009,2014,5,3.1
Tyreke Evans ,1569,4,7,2009,2015,6,4.6
Tyreke Evans ,1569,4,7,2009,2016,7,1.4
Tyrone Corbin ,1570,35,16,1985,1986,1,0.1
Tyrone Corbin ,1570,35,16,1985,1987,2,1.2
Tyrone Corbin ,1570,35,16,1985,1988,3,3
Tyrone Corbin ,1570,35,16,1985,1989,4,5.4
Tyrone Corbin ,1570,35,16,1985,1990,5,6.8
Tyrone Corbin ,1570,35,16,1985,1991,6,5.4
Tyrone Corbin ,1570,35,16,1985,1992,7,5.6
Tyrone Corbin ,1570,35,16,1985,1993,8,6.7
Tyrone Corbin ,1570,35,16,1985,1994,9,4.4
Tyrone Corbin ,1570,35,16,1985,1995,10,2.1
Tyrone Corbin ,1570,35,16,1985,1996,11,2.5
Tyrone Corbin ,1570,35,16,1985,1997,12,5
Tyrone Corbin ,1570,35,16,1985,1998,13,5.5
Tyrone Corbin ,1570,35,16,1985,1999,14,2.2
Tyrone Corbin ,1570,35,16,1985,2000,15,0.9
Tyrone Corbin ,1570,35,16,1985,2001,16,-0.3
Tyrone Hill ,1571,11,14,1990,1991,1,2.1
Tyrone Hill ,1571,11,14,1990,1992,2,4.5
Tyrone Hill ,1571,11,14,1990,1993,3,4.9
Tyrone Hill ,1571,11,14,1990,1994,4,5.7
Tyrone Hill ,1571,11,14,1990,1995,5,6.9
Tyrone Hill ,1571,11,14,1990,1996,6,1.9
Tyrone Hill ,1571,11,14,1990,1997,7,9.9
Tyrone Hill ,1571,11,14,1990,1998,8,4.8
Tyrone Hill ,1571,11,14,1990,1999,9,2.2
Tyrone Hill ,1571,11,14,1990,2000,10,5.7
Tyrone Hill ,1571,11,14,1990,2001,11,5.5
Tyrone Hill ,1571,11,14,1990,2002,12,0.6
Tyrone Hill ,1571,11,14,1990,2003,13,1.4
Tyrone Hill ,1571,11,14,1990,2004,14,0.1
Tyronn Lue ,1572,23,11,1998,1999,1,0.2
Tyronn Lue ,1572,23,11,1998,2000,2,0.3
Tyronn Lue ,1572,23,11,1998,2001,3,0.4
Tyronn Lue ,1572,23,11,1998,2002,4,2
Tyronn Lue ,1572,23,11,1998,2003,5,3.7
Tyronn Lue ,1572,23,11,1998,2004,6,2.1
Tyronn Lue ,1572,23,11,1998,2005,7,3.7
Tyronn Lue ,1572,23,11,1998,2006,8,2.7
Tyronn Lue ,1572,23,11,1998,2007,9,2.5
Tyronn Lue ,1572,23,11,1998,2008,10,1.2
Tyronn Lue ,1572,23,11,1998,2009,11,0.8
Tyrus Thomas ,1573,4,8,2006,2007,1,2.2
Tyrus Thomas ,1573,4,8,2006,2008,2,2.4
Tyrus Thomas ,1573,4,8,2006,2009,3,4.6
Tyrus Thomas ,1573,4,8,2006,2010,4,2.6
Tyrus Thomas ,1573,4,8,2006,2011,5,1.8
Tyrus Thomas ,1573,4,8,2006,2012,6,-0.6
Tyrus Thomas ,1573,4,8,2006,2013,7,-0.2
Tyrus Thomas ,1573,4,8,2006,2015,9,0.1
Tyshawn Taylor ,1574,41,2,2012,2013,1,-0.4
Tyshawn Taylor ,1574,41,2,2012,2014,2,-0.6
Tyson Chandler ,1575,2,15,2001,2002,1,1.8
Tyson Chandler ,1575,2,15,2001,2003,2,3.9
Tyson Chandler ,1575,2,15,2001,2004,3,1.9
Tyson Chandler ,1575,2,15,2001,2005,4,8.3
Tyson Chandler ,1575,2,15,2001,2006,5,5.4
Tyson Chandler ,1575,2,15,2001,2007,6,7.9
Tyson Chandler ,1575,2,15,2001,2008,7,10
Tyson Chandler ,1575,2,15,2001,2009,8,3.4
Tyson Chandler ,1575,2,15,2001,2010,9,2.9
Tyson Chandler ,1575,2,15,2001,2011,10,9.4
Tyson Chandler ,1575,2,15,2001,2012,11,9.5
Tyson Chandler ,1575,2,15,2001,2013,12,9.3
Tyson Chandler ,1575,2,15,2001,2014,13,4.9
Tyson Chandler ,1575,2,15,2001,2015,14,10.3
Tyson Chandler ,1575,2,15,2001,2016,15,3.8
Tyson Wheeler ,1576,47,1,1998,1999,1,0.1
Tyus Edney ,1577,47,4,1995,1996,1,3.3
Tyus Edney ,1577,47,4,1995,1997,2,1.5
Tyus Edney ,1577,47,4,1995,1998,3,1.4
Tyus Edney ,1577,47,4,1995,2001,6,0.5
Tyus Jones ,1578,24,1,2015,2016,1,0.3
Uwe Blab ,1579,17,5,1985,1986,1,0.1
Uwe Blab ,1579,17,5,1985,1987,2,-0.1
Uwe Blab ,1579,17,5,1985,1988,3,0.5
Uwe Blab ,1579,17,5,1985,1989,4,0.3
Uwe Blab ,1579,17,5,1985,1990,5,-0.4
Vassilis Spanoulis ,1580,50,1,2004,2007,3,-0.1
Vern Fleming ,1581,18,12,1984,1985,1,3.3
Vern Fleming ,1581,18,12,1984,1986,2,6.9
Vern Fleming ,1581,18,12,1984,1987,3,7
Vern Fleming ,1581,18,12,1984,1988,4,8.4
Vern Fleming ,1581,18,12,1984,1989,5,5.6
Vern Fleming ,1581,18,12,1984,1990,6,6.7
Vern Fleming ,1581,18,12,1984,1991,7,4.4
Vern Fleming ,1581,18,12,1984,1992,8,2
Vern Fleming ,1581,18,12,1984,1993,9,2.9
Vern Fleming ,1581,18,12,1984,1994,10,1.4
Vern Fleming ,1581,18,12,1984,1995,11,1.9
Vern Fleming ,1581,18,12,1984,1996,12,1.6
Vernon Maxwell ,1582,47,13,1988,1989,1,1.5
Vernon Maxwell ,1582,47,13,1988,1990,2,2.8
Vernon Maxwell ,1582,47,13,1988,1991,3,5.9
Vernon Maxwell ,1582,47,13,1988,1992,4,3.9
Vernon Maxwell ,1582,47,13,1988,1993,5,3.9
Vernon Maxwell ,1582,47,13,1988,1994,6,3.5
Vernon Maxwell ,1582,47,13,1988,1995,7,1.9
Vernon Maxwell ,1582,47,13,1988,1996,8,0.9
Vernon Maxwell ,1582,47,13,1988,1997,9,0
Vernon Maxwell ,1582,47,13,1988,1998,10,0.8
Vernon Maxwell ,1582,47,13,1988,1999,11,1.6
Vernon Maxwell ,1582,47,13,1988,2000,12,0.8
Vernon Maxwell ,1582,47,13,1988,2001,13,0
Victor Alexander ,1583,17,5,1991,1992,1,2.5
Victor Alexander ,1583,17,5,1991,1993,2,3
Victor Alexander ,1583,17,5,1991,1994,3,2.3
Victor Alexander ,1583,17,5,1991,1995,4,1.1
Victor Alexander ,1583,17,5,1991,2002,11,-0.1
Victor Claver ,1584,22,3,2009,2013,4,-0.1
Victor Claver ,1584,22,3,2009,2014,5,0.2
Victor Claver ,1584,22,3,2009,2015,6,0.1
Victor Oladipo ,1585,2,3,2013,2014,1,1.3
Victor Oladipo ,1585,2,3,2013,2015,2,3.5
Victor Oladipo ,1585,2,3,2013,2016,3,4.9
Viktor Khryapa ,1586,22,4,2004,2005,1,0.3
Viktor Khryapa ,1586,22,4,2004,2006,2,1.3
Viktor Khryapa ,1586,22,4,2004,2007,3,0.4
Viktor Khryapa ,1586,22,4,2004,2008,4,0
Vin Baker ,1587,8,13,1993,1994,1,4.4
Vin Baker ,1587,8,13,1993,1995,2,5.8
Vin Baker ,1587,8,13,1993,1996,3,6.2
Vin Baker ,1587,8,13,1993,1997,4,8.3
Vin Baker ,1587,8,13,1993,1998,5,10.4
Vin Baker ,1587,8,13,1993,1999,6,0.4
Vin Baker ,1587,8,13,1993,2000,7,3.5
Vin Baker ,1587,8,13,1993,2001,8,1.8
Vin Baker ,1587,8,13,1993,2002,9,2.2
Vin Baker ,1587,8,13,1993,2003,10,1.6
Vin Baker ,1587,8,13,1993,2004,11,2.8
Vin Baker ,1587,8,13,1993,2005,12,-0.4
Vin Baker ,1587,8,13,1993,2006,13,0.1
Vince Carter ,1588,5,18,1998,1999,1,5
Vince Carter ,1588,5,18,1998,2000,2,11.8
Vince Carter ,1588,5,18,1998,2001,3,12.9
Vince Carter ,1588,5,18,1998,2002,4,7
Vince Carter ,1588,5,18,1998,2003,5,4.2
Vince Carter ,1588,5,18,1998,2004,6,6
Vince Carter ,1588,5,18,1998,2005,7,9.4
Vince Carter ,1588,5,18,1998,2006,8,9.3
Vince Carter ,1588,5,18,1998,2007,9,10.5
Vince Carter ,1588,5,18,1998,2008,10,7.7
Vince Carter ,1588,5,18,1998,2009,11,7.5
Vince Carter ,1588,5,18,1998,2010,12,7.4
Vince Carter ,1588,5,18,1998,2011,13,3.8
Vince Carter ,1588,5,18,1998,2012,14,2.9
Vince Carter ,1588,5,18,1998,2013,15,6
Vince Carter ,1588,5,18,1998,2014,16,4.3
Vince Carter ,1588,5,18,1998,2015,17,1
Vince Carter ,1588,5,18,1998,2016,18,1.8
Vince Taylor ,1589,34,1,1982,1983,1,0.1
Vincent Askew ,1590,39,9,1987,1988,1,-0.2
Vincent Askew ,1590,39,9,1987,1991,4,0.2
Vincent Askew ,1590,39,9,1987,1992,5,2.9
Vincent Askew ,1590,39,9,1987,1993,6,2.7
Vincent Askew ,1590,39,9,1987,1994,7,6
Vincent Askew ,1590,39,9,1987,1995,8,4.6
Vincent Askew ,1590,39,9,1987,1996,9,4.3
Vincent Askew ,1590,39,9,1987,1997,10,1.5
Vincent Askew ,1590,39,9,1987,1998,11,0.2
Vincent Yarbrough ,1591,32,1,2002,2003,1,1
Vinnie Johnson ,1592,7,13,1979,1980,1,0.2
Vinnie Johnson ,1592,7,13,1979,1981,2,5.9
Vinnie Johnson ,1592,7,13,1979,1982,3,2.7
Vinnie Johnson ,1592,7,13,1979,1983,4,7.7
Vinnie Johnson ,1592,7,13,1979,1984,5,4.1
Vinnie Johnson ,1592,7,13,1979,1985,6,4.2
Vinnie Johnson ,1592,7,13,1979,1986,7,4.7
Vinnie Johnson ,1592,7,13,1979,1987,8,4.8
Vinnie Johnson ,1592,7,13,1979,1988,9,2.3
Vinnie Johnson ,1592,7,13,1979,1989,10,5.9
Vinnie Johnson ,1592,7,13,1979,1990,11,3.2
Vinnie Johnson ,1592,7,13,1979,1991,12,3.8
Vinnie Johnson ,1592,7,13,1979,1992,13,1.2
Vinny Del Negro ,1593,29,12,1988,1989,1,2.5
Vinny Del Negro ,1593,29,12,1988,1990,2,2.2
Vinny Del Negro ,1593,29,12,1988,1993,5,3.5
Vinny Del Negro ,1593,29,12,1988,1994,6,5.7
Vinny Del Negro ,1593,29,12,1988,1995,7,6.8
Vinny Del Negro ,1593,29,12,1988,1996,8,8.3
Vinny Del Negro ,1593,29,12,1988,1997,9,3.1
Vinny Del Negro ,1593,29,12,1988,1998,10,3.7
Vinny Del Negro ,1593,29,12,1988,1999,11,1.6
Vinny Del Negro ,1593,29,12,1988,2000,12,1.5
Vinny Del Negro ,1593,29,12,1988,2001,13,1.6
Vinny Del Negro ,1593,29,12,1988,2002,14,0
Vitaly Potapenko ,1594,12,11,1996,1997,1,0.5
Vitaly Potapenko ,1594,12,11,1996,1998,2,1.5
Vitaly Potapenko ,1594,12,11,1996,1999,3,2.2
Vitaly Potapenko ,1594,12,11,1996,2000,4,2.5
Vitaly Potapenko ,1594,12,11,1996,2001,5,3.4
Vitaly Potapenko ,1594,12,11,1996,2002,6,3.1
Vitaly Potapenko ,1594,12,11,1996,2003,7,0.2
Vitaly Potapenko ,1594,12,11,1996,2004,8,1.1
Vitaly Potapenko ,1594,12,11,1996,2005,9,1
Vitaly Potapenko ,1594,12,11,1996,2006,10,0.1
Vitaly Potapenko ,1594,12,11,1996,2007,11,-0.1
Vlade Divac ,1595,26,16,1989,1990,1,5
Vlade Divac ,1595,26,16,1989,1991,2,8.3
Vlade Divac ,1595,26,16,1989,1992,3,1.8
Vlade Divac ,1595,26,16,1989,1993,4,5.6
Vlade Divac ,1595,26,16,1989,1994,5,7.4
Vlade Divac ,1595,26,16,1989,1995,6,9.5
Vlade Divac ,1595,26,16,1989,1996,7,6.1
Vlade Divac ,1595,26,16,1989,1997,8,7.3
Vlade Divac ,1595,26,16,1989,1998,9,5.9
Vlade Divac ,1595,26,16,1989,1999,10,5.2
Vlade Divac ,1595,26,16,1989,2000,11,7.2
Vlade Divac ,1595,26,16,1989,2001,12,7.4
Vlade Divac ,1595,26,16,1989,2002,13,7.3
Vlade Divac ,1595,26,16,1989,2003,14,7
Vlade Divac ,1595,26,16,1989,2004,15,5.3
Vlade Divac ,1595,26,16,1989,2005,16,0
Vladimir Radmanovic ,1596,12,12,2001,2002,1,2.1
Vladimir Radmanovic ,1596,12,12,2001,2003,2,2.7
Vladimir Radmanovic ,1596,12,12,2001,2004,3,4.2
Vladimir Radmanovic ,1596,12,12,2001,2005,4,3.7
Vladimir Radmanovic ,1596,12,12,2001,2006,5,3.8
Vladimir Radmanovic ,1596,12,12,2001,2007,6,0.8
Vladimir Radmanovic ,1596,12,12,2001,2008,7,3.5
Vladimir Radmanovic ,1596,12,12,2001,2009,8,1.9
Vladimir Radmanovic ,1596,12,12,2001,2010,9,0
Vladimir Radmanovic ,1596,12,12,2001,2011,10,2.1
Vladimir Radmanovic ,1596,12,12,2001,2012,11,1.6
Vladimir Radmanovic ,1596,12,12,2001,2013,12,0.1
Vladimir Stepania ,1597,27,6,1998,1999,1,-0.1
Vladimir Stepania ,1597,27,6,1998,2000,2,-0.3
Vladimir Stepania ,1597,27,6,1998,2001,3,0.2
Vladimir Stepania ,1597,27,6,1998,2002,4,1.7
Vladimir Stepania ,1597,27,6,1998,2003,5,2.9
Vladimir Stepania ,1597,27,6,1998,2004,6,0.8
Voise Winters ,1598,44,1,1985,1986,1,-0.1
Von Wafer ,1599,39,6,2005,2006,1,-0.3
Von Wafer ,1599,39,6,2005,2007,2,0
Von Wafer ,1599,39,6,2005,2008,3,-0.5
Von Wafer ,1599,39,6,2005,2009,4,2.6
Von Wafer ,1599,39,6,2005,2011,6,1.1
Von Wafer ,1599,39,6,2005,2012,7,0.4
Vonteego Cummings ,1600,26,3,1999,2000,1,1.3
Vonteego Cummings ,1600,26,3,1999,2001,2,0.2
Vonteego Cummings ,1600,26,3,1999,2002,3,0.6
Voshon Lenard ,1601,46,11,1994,1996,2,0.9
Voshon Lenard ,1601,46,11,1994,1997,3,6.8
Voshon Lenard ,1601,46,11,1994,1998,4,7.1
Voshon Lenard ,1601,46,11,1994,1999,5,0.3
Voshon Lenard ,1601,46,11,1994,2000,6,3
Voshon Lenard ,1601,46,11,1994,2001,7,3.5
Voshon Lenard ,1601,46,11,1994,2002,8,1.7
Voshon Lenard ,1601,46,11,1994,2003,9,2.4
Voshon Lenard ,1601,46,11,1994,2004,10,4
Voshon Lenard ,1601,46,11,1994,2005,11,0.1
Voshon Lenard ,1601,46,11,1994,2006,12,-0.1
Wallace Bryant ,1602,30,3,1982,1984,2,0
Wallace Bryant ,1602,30,3,1982,1985,3,1.3
Wallace Bryant ,1602,30,3,1982,1986,4,0
Wally Szczerbiak ,1603,6,10,1999,2000,1,6.2
Wally Szczerbiak ,1603,6,10,1999,2001,2,7.4
Wally Szczerbiak ,1603,6,10,1999,2002,3,8.7
Wally Szczerbiak ,1603,6,10,1999,2003,4,5.2
Wally Szczerbiak ,1603,6,10,1999,2004,5,1.6
Wally Szczerbiak ,1603,6,10,1999,2005,6,7.3
Wally Szczerbiak ,1603,6,10,1999,2006,7,8
Wally Szczerbiak ,1603,6,10,1999,2007,8,1.6
Wally Szczerbiak ,1603,6,10,1999,2008,9,2.9
Wally Szczerbiak ,1603,6,10,1999,2009,10,4.5
Walt Williams ,1604,7,11,1992,1993,1,1.6
Walt Williams ,1604,7,11,1992,1994,2,-0.7
Walt Williams ,1604,7,11,1992,1995,3,5.1
Walt Williams ,1604,7,11,1992,1996,4,5.1
Walt Williams ,1604,7,11,1992,1997,5,5.4
Walt Williams ,1604,7,11,1992,1998,6,2.2
Walt Williams ,1604,7,11,1992,1999,7,3.7
Walt Williams ,1604,7,11,1992,2000,8,4.4
Walt Williams ,1604,7,11,1992,2001,9,3
Walt Williams ,1604,7,11,1992,2002,10,1.7
Walt Williams ,1604,7,11,1992,2003,11,2.5
Walter Berry ,1605,14,3,1986,1987,1,2.3
Walter Berry ,1605,14,3,1986,1988,2,3.4
Walter Berry ,1605,14,3,1986,1989,3,2.4
Walter McCarty ,1606,19,10,1996,1997,1,0
Walter McCarty ,1606,19,10,1996,1998,2,2.9
Walter McCarty ,1606,19,10,1996,1999,3,0.5
Walter McCarty ,1606,19,10,1996,2000,4,-0.2
Walter McCarty ,1606,19,10,1996,2001,5,0.7
Walter McCarty ,1606,19,10,1996,2002,6,1.8
Walter McCarty ,1606,19,10,1996,2003,7,4.1
Walter McCarty ,1606,19,10,1996,2004,8,2.9
Walter McCarty ,1606,19,10,1996,2005,9,1.1
Walter McCarty ,1606,19,10,1996,2006,10,0
Walter Palmer ,1607,33,2,1990,1991,1,-0.1
Walter Palmer ,1607,33,2,1990,1993,3,0
Walter Sharpe ,1608,32,1,2008,2009,1,-0.1
Walter Tavares ,1609,43,1,2014,2016,2,0.2
Wang Zhizhi ,1610,36,5,1999,2001,2,0.1
Wang Zhizhi ,1610,36,5,1999,2002,3,1.5
Wang Zhizhi ,1610,36,5,1999,2003,4,0.1
Wang Zhizhi ,1610,36,5,1999,2004,5,0.1
Wang Zhizhi ,1610,36,5,1999,2005,6,0.2
Wayman Tisdale ,1611,2,12,1985,1986,1,3.2
Wayman Tisdale ,1611,2,12,1985,1987,2,5.6
Wayman Tisdale ,1611,2,12,1985,1988,3,5.7
Wayman Tisdale ,1611,2,12,1985,1989,4,5.9
Wayman Tisdale ,1611,2,12,1985,1990,5,7
Wayman Tisdale ,1611,2,12,1985,1991,6,1.8
Wayman Tisdale ,1611,2,12,1985,1992,7,3.4
Wayman Tisdale ,1611,2,12,1985,1993,8,4.5
Wayman Tisdale ,1611,2,12,1985,1994,9,5.4
Wayman Tisdale ,1611,2,12,1985,1995,10,1.7
Wayman Tisdale ,1611,2,12,1985,1996,11,2
Wayman Tisdale ,1611,2,12,1985,1997,12,-0.6
Wayne Cooper ,1612,40,14,1978,1979,1,1.2
Wayne Cooper ,1612,40,14,1978,1980,2,2.8
Wayne Cooper ,1612,40,14,1978,1981,3,1.5
Wayne Cooper ,1612,40,14,1978,1982,4,2.9
Wayne Cooper ,1612,40,14,1978,1983,5,2.9
Wayne Cooper ,1612,40,14,1978,1984,6,4.1
Wayne Cooper ,1612,40,14,1978,1985,7,3.5
Wayne Cooper ,1612,40,14,1978,1986,8,5.1
Wayne Cooper ,1612,40,14,1978,1987,9,2
Wayne Cooper ,1612,40,14,1978,1988,10,1.2
Wayne Cooper ,1612,40,14,1978,1989,11,5
Wayne Cooper ,1612,40,14,1978,1990,12,2.7
Wayne Cooper ,1612,40,14,1978,1991,13,1.4
Wayne Cooper ,1612,40,14,1978,1992,14,0.7
Wayne Ellington ,1613,28,7,2009,2010,1,0.4
Wayne Ellington ,1613,28,7,2009,2011,2,0.3
Wayne Ellington ,1613,28,7,2009,2012,3,0.8
Wayne Ellington ,1613,28,7,2009,2013,4,3.2
Wayne Ellington ,1613,28,7,2009,2014,5,0.7
Wayne Ellington ,1613,28,7,2009,2015,6,1.2
Wayne Ellington ,1613,28,7,2009,2016,7,0.8
Wayne Radford ,1614,27,1,1978,1979,1,0.7
Wayne Robinson ,1615,31,1,1980,1981,1,1.7
Wayne Sappleton ,1616,38,1,1982,1985,3,0.1
Wayne Simien ,1617,29,2,2005,2006,1,0.8
Wayne Simien ,1617,29,2,2005,2007,2,0
Wes Matthews ,1618,14,9,1980,1981,1,2.6
Wes Matthews ,1618,14,9,1980,1982,2,1.3
Wes Matthews ,1618,14,9,1980,1983,3,0.7
Wes Matthews ,1618,14,9,1980,1984,4,0.4
Wes Matthews ,1618,14,9,1980,1985,5,1.6
Wes Matthews ,1618,14,9,1980,1986,6,3
Wes Matthews ,1618,14,9,1980,1987,7,0.6
Wes Matthews ,1618,14,9,1980,1988,8,0.8
Wes Matthews ,1618,14,9,1980,1990,10,0.1
Wesley Johnson ,1619,4,6,2010,2011,1,1.3
Wesley Johnson ,1619,4,6,2010,2012,2,0.6
Wesley Johnson ,1619,4,6,2010,2013,3,0
Wesley Johnson ,1619,4,6,2010,2014,4,1.9
Wesley Johnson ,1619,4,6,2010,2015,5,1.7
Wesley Johnson ,1619,4,6,2010,2016,6,2.6
Wesley Person ,1620,23,11,1994,1995,1,3.8
Wesley Person ,1620,23,11,1994,1996,2,4
Wesley Person ,1620,23,11,1994,1997,3,5.2
Wesley Person ,1620,23,11,1994,1998,4,10.3
Wesley Person ,1620,23,11,1994,1999,5,2.6
Wesley Person ,1620,23,11,1994,2000,6,3.7
Wesley Person ,1620,23,11,1994,2001,7,1.2
Wesley Person ,1620,23,11,1994,2002,8,6.9
Wesley Person ,1620,23,11,1994,2003,9,3.3
Wesley Person ,1620,23,11,1994,2004,10,1.3
Wesley Person ,1620,23,11,1994,2005,11,1.6
Wiley Peck ,1621,19,1,1979,1980,1,0.3
Will Barton ,1622,40,4,2012,2013,1,-0.5
Will Barton ,1622,40,4,2012,2014,2,0.6
Will Barton ,1622,40,4,2012,2015,3,1.3
Will Barton ,1622,40,4,2012,2016,4,4.3
Will Perdue ,1623,11,13,1988,1989,1,-0.1
Will Perdue ,1623,11,13,1988,1990,2,0.5
Will Perdue ,1623,11,13,1988,1991,3,2.3
Will Perdue ,1623,11,13,1988,1992,4,2.5
Will Perdue ,1623,11,13,1988,1993,5,2.5
Will Perdue ,1623,11,13,1988,1994,6,0.2
Will Perdue ,1623,11,13,1988,1995,7,4.7
Will Perdue ,1623,11,13,1988,1996,8,3.4
Will Perdue ,1623,11,13,1988,1997,9,4.4
Will Perdue ,1623,11,13,1988,1998,10,4.7
Will Perdue ,1623,11,13,1988,1999,11,1.5
Will Perdue ,1623,11,13,1988,2000,12,-0.5
Will Perdue ,1623,11,13,1988,2001,13,0.3
Will Solomon ,1624,32,2,2001,2002,1,-0.5
Will Solomon ,1624,32,2,2001,2009,8,0.5
William Avery ,1625,14,3,1999,2000,1,-0.5
William Avery ,1625,14,3,1999,2001,2,0
William Avery ,1625,14,3,1999,2002,3,-0.4
William Bedford ,1626,6,6,1986,1987,1,-0.8
William Bedford ,1626,6,6,1986,1988,2,0.2
William Bedford ,1626,6,6,1986,1990,4,-0.1
William Bedford ,1626,6,6,1986,1991,5,1.3
William Bedford ,1626,6,6,1986,1992,6,0.3
William Bedford ,1626,6,6,1986,1993,7,-0.1
Willie Anderson ,1627,10,9,1988,1989,1,4.9
Willie Anderson ,1627,10,9,1988,1990,2,6.5
Willie Anderson ,1627,10,9,1988,1991,3,4.8
Willie Anderson ,1627,10,9,1988,1992,4,3.3
Willie Anderson ,1627,10,9,1988,1993,5,-0.1
Willie Anderson ,1627,10,9,1988,1994,6,5.6
Willie Anderson ,1627,10,9,1988,1995,7,0.7
Willie Anderson ,1627,10,9,1988,1996,8,1.4
Willie Anderson ,1627,10,9,1988,1997,9,0.9
Willie Burton ,1628,9,8,1990,1991,1,2.1
Willie Burton ,1628,9,8,1990,1992,2,2
Willie Burton ,1628,9,8,1990,1993,3,0.1
Willie Burton ,1628,9,8,1990,1994,4,1.6
Willie Burton ,1628,9,8,1990,1995,5,2.6
Willie Burton ,1628,9,8,1990,1997,7,0.5
Willie Burton ,1628,9,8,1990,1998,8,0.2
Willie Burton ,1628,9,8,1990,1999,9,-0.1
Willie Cauley-Stein ,1629,6,1,2015,2016,1,3.8
Willie Green ,1630,41,12,2003,2004,1,0
Willie Green ,1630,41,12,2003,2005,2,0.1
Willie Green ,1630,41,12,2003,2006,3,-0.1
Willie Green ,1630,41,12,2003,2007,4,-0.7
Willie Green ,1630,41,12,2003,2008,5,2.1
Willie Green ,1630,41,12,2003,2009,6,2.3
Willie Green ,1630,41,12,2003,2010,7,2.2
Willie Green ,1630,41,12,2003,2011,8,1.8
Willie Green ,1630,41,12,2003,2012,9,2.4
Willie Green ,1630,41,12,2003,2013,10,2.5
Willie Green ,1630,41,12,2003,2014,11,0.5
Willie Green ,1630,41,12,2003,2015,12,-0.1
Willie White ,1631,42,2,1984,1985,1,-0.2
Willie White ,1631,42,2,1984,1986,2,0.5
Wilson Chandler ,1632,23,8,2007,2008,1,0.5
Wilson Chandler ,1632,23,8,2007,2009,2,3.1
Wilson Chandler ,1632,23,8,2007,2010,3,2.7
Wilson Chandler ,1632,23,8,2007,2011,4,3.9
Wilson Chandler ,1632,23,8,2007,2012,5,-0.1
Wilson Chandler ,1632,23,8,2007,2013,6,3.1
Wilson Chandler ,1632,23,8,2007,2014,7,3.1
Wilson Chandler ,1632,23,8,2007,2015,8,3.6
Winford Boynes ,1633,13,3,1978,1979,1,0.6
Winford Boynes ,1633,13,3,1978,1980,2,1.7
Winford Boynes ,1633,13,3,1978,1981,3,-1.4
Winston Garland ,1634,40,7,1987,1988,1,1.7
Winston Garland ,1634,40,7,1987,1989,2,4.5
Winston Garland ,1634,40,7,1987,1990,3,-0.3
Winston Garland ,1634,40,7,1987,1991,4,2.4
Winston Garland ,1634,40,7,1987,1992,5,2.9
Winston Garland ,1634,40,7,1987,1993,6,1.8
Winston Garland ,1634,40,7,1987,1995,8,1.2
Xavier Henry ,1635,12,5,2010,2011,1,0.2
Xavier Henry ,1635,12,5,2010,2012,2,0.2
Xavier Henry ,1635,12,5,2010,2013,3,0
Xavier Henry ,1635,12,5,2010,2014,4,0.3
Xavier Henry ,1635,12,5,2010,2015,5,-0.1
Xavier McDaniel ,1636,4,12,1985,1986,1,5.1
Xavier McDaniel ,1636,4,12,1985,1987,2,7.4
Xavier McDaniel ,1636,4,12,1985,1988,3,6.2
Xavier McDaniel ,1636,4,12,1985,1989,4,5.3
Xavier McDaniel ,1636,4,12,1985,1990,5,5.4
Xavier McDaniel ,1636,4,12,1985,1991,6,5.1
Xavier McDaniel ,1636,4,12,1985,1992,7,4.6
Xavier McDaniel ,1636,4,12,1985,1993,8,4.4
Xavier McDaniel ,1636,4,12,1985,1994,9,2.3
Xavier McDaniel ,1636,4,12,1985,1995,10,1.4
Xavier McDaniel ,1636,4,12,1985,1997,12,0.7
Xavier McDaniel ,1636,4,12,1985,1998,13,0
Yao Ming ,1637,1,8,2002,2003,1,8.7
Yao Ming ,1637,1,8,2002,2004,2,11.4
Yao Ming ,1637,1,8,2002,2005,3,10.7
Yao Ming ,1637,1,8,2002,2006,4,8.6
Yao Ming ,1637,1,8,2002,2009,7,10.6
Yao Ming ,1637,1,8,2002,2011,9,0.3
Yaroslav Korolev ,1638,12,2,2005,2006,1,0
Yaroslav Korolev ,1638,12,2,2005,2007,2,0
Yi Jianlian ,1639,6,5,2007,2008,1,0.7
Yi Jianlian ,1639,6,5,2007,2009,2,0.7
Yi Jianlian ,1639,6,5,2007,2010,3,1.3
Yi Jianlian ,1639,6,5,2007,2011,4,0.4
Yi Jianlian ,1639,6,5,2007,2012,5,0
Yinka Dare ,1640,14,4,1994,1995,1,0
Yinka Dare ,1640,14,4,1994,1996,2,-0.5
Yinka Dare ,1640,14,4,1994,1997,3,-0.1
Yinka Dare ,1640,14,4,1994,1998,4,-0.1
Yvon Joseph ,1641,36,1,1985,1986,1,0
Zach LaVine ,1642,13,2,2014,2015,1,-0.7
Zach LaVine ,1642,13,2,2014,2016,2,2.6
Zach Randolph ,1643,19,15,2001,2002,1,0.5
Zach Randolph ,1643,19,15,2001,2003,2,4.8
Zach Randolph ,1643,19,15,2001,2004,3,7.1
Zach Randolph ,1643,19,15,2001,2005,4,3.1
Zach Randolph ,1643,19,15,2001,2006,5,1.3
Zach Randolph ,1643,19,15,2001,2007,6,5.7
Zach Randolph ,1643,19,15,2001,2008,7,3
Zach Randolph ,1643,19,15,2001,2009,8,3
Zach Randolph ,1643,19,15,2001,2010,9,9.7
Zach Randolph ,1643,19,15,2001,2011,10,10.5
Zach Randolph ,1643,19,15,2001,2012,11,2.1
Zach Randolph ,1643,19,15,2001,2013,12,7.9
Zach Randolph ,1643,19,15,2001,2014,13,6.4
Zach Randolph ,1643,19,15,2001,2015,14,7.2
Zach Randolph ,1643,19,15,2001,2016,15,4.3
Zarko Cabarkapa ,1644,17,3,2003,2004,1,-0.4
Zarko Cabarkapa ,1644,17,3,2003,2005,2,1.3
Zarko Cabarkapa ,1644,17,3,2003,2006,3,0.3
Zaza Pachulia ,1645,42,13,2003,2004,1,0.3
Zaza Pachulia ,1645,42,13,2003,2005,2,2.9
Zaza Pachulia ,1645,42,13,2003,2006,3,3.9
Zaza Pachulia ,1645,42,13,2003,2007,4,4.8
Zaza Pachulia ,1645,42,13,2003,2008,5,1.1
Zaza Pachulia ,1645,42,13,2003,2009,6,3.9
Zaza Pachulia ,1645,42,13,2003,2010,7,2.7
Zaza Pachulia ,1645,42,13,2003,2011,8,3.1
Zaza Pachulia ,1645,42,13,2003,2012,9,5
Zaza Pachulia ,1645,42,13,2003,2013,10,2.7
Zaza Pachulia ,1645,42,13,2003,2014,11,1.7
Zaza Pachulia ,1645,42,13,2003,2015,12,4.2
Zaza Pachulia ,1645,42,13,2003,2016,13,6
Zoran Planinic ,1646,22,3,2003,2004,1,0.7
Zoran Planinic ,1646,22,3,2003,2005,2,0.8
Zoran Planinic ,1646,22,3,2003,2006,3,0.1
Zydrunas Ilgauskas ,1647,20,13,1996,1998,2,9.4
Zydrunas Ilgauskas ,1647,20,13,1996,1999,3,0.5
Zydrunas Ilgauskas ,1647,20,13,1996,2001,5,0.7
Zydrunas Ilgauskas ,1647,20,13,1996,2002,6,2.5
Zydrunas Ilgauskas ,1647,20,13,1996,2003,7,5
Zydrunas Ilgauskas ,1647,20,13,1996,2004,8,7.8
Zydrunas Ilgauskas ,1647,20,13,1996,2005,9,8.1
Zydrunas Ilgauskas ,1647,20,13,1996,2006,10,8.7
Zydrunas Ilgauskas ,1647,20,13,1996,2007,11,6.6
Zydrunas Ilgauskas ,1647,20,13,1996,2008,12,6.1
Zydrunas Ilgauskas ,1647,20,13,1996,2009,13,5.6
Zydrunas Ilgauskas ,1647,20,13,1996,2010,14,2.5
Zydrunas Ilgauskas ,1647,20,13,1996,2011,15,2.9